"","Rk","Player","Season","Pos","G","GS","MP","FG","FGA","FG.","X2P","X2PA","X2P.","X3P","X3PA","X3P.","FT","FTA","FT.","ORB","DRB","TRB","AST","STL","BLK","TOV","PF","PTS","Player.additional"
"1",1,"DeMar DeRozan","2021-22","G-F",77,79,707,236,438,0.539,221,401,0.551,15,37,0.405,165,190,0.868,17,101,118,100,23,6,35,47,652,"derozde01"
"2",2,"Jayson Tatum","2021-22","F",90,97,856,197,442,0.446,141,287,0.491,56,155,0.361,167,194,0.861,33,131,164,99,24,15,82,70,617,"tatumja01"
"3",3,"Giannis Antetokounmpo","2021-22","F-G",75,76,636,200,373,0.536,179,308,0.581,21,65,0.323,175,245,0.714,48,200,248,104,20,24,71,84,596,"antetgi01"
"4",4,"Stephen Curry","2021-22","G",76,74,628,172,381,0.451,92,154,0.597,80,227,0.352,87,97,0.897,6,93,99,112,21,7,54,44,511,"curryst01"
"5",5,"LeBron James","2021-22","F-G",54,62,565,174,356,0.489,131,217,0.604,43,139,0.309,72,96,0.75,14,104,118,103,23,17,44,44,463,"jamesle01"
"6",6,"Trae Young","2021-22","G",76,77,544,144,334,0.431,102,198,0.515,42,136,0.309,121,138,0.877,8,52,60,107,10,0,57,28,451,"youngtr01"
"7",7,"Joel Embiid","2021-22","C",72,77,518,142,293,0.485,121,226,0.535,21,67,0.313,142,173,0.821,36,131,167,48,14,36,48,66,447,"embiijo01"
"8",8,"Luka Dončić","2021-22","G-F",72,74,583,152,338,0.45,103,199,0.518,49,139,0.353,86,118,0.729,10,140,150,112,26,11,50,57,439,"doncilu01"
"9",9,"Jaylen Brown","2021-22","F-G",84,91,713,155,350,0.443,106,212,0.5,49,138,0.355,79,115,0.687,24,116,140,61,20,8,60,66,438,"brownja02"
"10",10,"Nikola Jokić","2021-22","C-F",68,72,506,153,294,0.52,142,243,0.584,11,51,0.216,111,145,0.766,52,138,190,100,22,17,53,52,428,"jokicni01"
"11",11,"Chris Paul","2021-22","G",71,72,646,154,287,0.537,120,204,0.588,34,83,0.41,81,98,0.827,11,84,95,200,35,7,54,59,423,"paulch01"
"12",12,"Jordan Poole","2021-22","G",94,54,673,135,305,0.443,93,160,0.581,42,145,0.29,107,115,0.93,13,66,79,73,14,5,54,69,419,"poolejo01"
"13",13,"Buddy Hield","2021-22","G",78,33,693,141,306,0.461,55,103,0.534,86,203,0.424,49,52,0.942,16,77,93,38,18,3,35,66,417,"hieldbu01"
"14",14,"Jordan Clarkson","2021-22","G",84,1,677,147,336,0.438,86,155,0.555,61,181,0.337,59,69,0.855,16,67,83,50,22,4,39,52,414,"clarkjo01"
"15",15,"Tyler Herro","2021-22","G",79,10,779,143,345,0.414,88,196,0.449,55,149,0.369,62,71,0.873,9,102,111,87,12,4,53,31,403,"herroty01"
"16",16,"Donovan Mitchell","2021-22","G",68,70,529,138,344,0.401,103,209,0.493,35,135,0.259,89,111,0.802,19,53,72,87,24,2,53,55,400,"mitchdo01"
"17",17,"Tyrese Maxey","2021-22","G",82,86,745,137,280,0.489,94,188,0.5,43,92,0.467,73,87,0.839,9,57,66,83,15,8,24,51,390,"maxeyty01"
"18",18,"Anthony Edwards","2021-22","G",73,76,591,128,294,0.435,73,145,0.503,55,149,0.369,75,98,0.765,14,60,74,68,21,11,47,47,386,"edwaran01"
"19",19,"Ja Morant","2021-22","G",57,60,424,129,290,0.445,112,235,0.477,17,55,0.309,111,149,0.745,25,61,86,70,15,6,44,25,386,"moranja01"
"20",20,"Miles Bridges","2021-22","G-F",72,80,606,140,287,0.488,105,165,0.636,35,122,0.287,69,89,0.775,21,113,134,58,15,16,34,55,384,"bridgmi02"
"21",21,"Pascal Siakam","2021-22","F",70,78,689,135,298,0.453,125,265,0.472,10,33,0.303,101,138,0.732,47,128,175,86,21,18,48,84,381,"siakapa01"
"22",22,"Jalen Brunson","2021-22","G",88,74,778,146,304,0.48,130,247,0.526,16,57,0.281,69,85,0.812,14,82,96,114,10,1,38,59,377,"brunsja01"
"23",23,"Immanuel Quickley","2021-22","G",76,3,695,121,293,0.413,59,130,0.454,62,163,0.38,67,76,0.882,8,77,85,112,23,0,39,71,371,"quickim01"
"24",24,"Dejounte Murray","2021-22","G",63,67,559,144,314,0.459,127,251,0.506,17,63,0.27,63,85,0.741,19,104,123,114,30,1,46,40,368,"murrade01"
"25",25,"Zach LaVine","2021-22","G-F",64,66,509,119,256,0.465,86,155,0.555,33,101,0.327,96,111,0.865,3,65,68,46,5,3,33,34,367,"lavinza01"
"26",26,"Karl-Anthony Towns","2021-22","C-F",75,77,561,127,260,0.488,86,154,0.558,41,106,0.387,72,90,0.8,45,112,157,44,15,30,47,70,367,"townska01"
"27",27,"James Harden","2021-22","G",72,74,695,102,258,0.395,63,131,0.481,39,127,0.307,122,144,0.847,17,114,131,145,20,12,78,51,365,"hardeja01"
"28",28,"Jaren Jackson Jr.","2021-22","F",82,86,614,112,279,0.401,65,157,0.414,47,122,0.385,90,115,0.783,36,88,124,31,10,63,39,86,361,"jacksja02"
"29",29,"Terry Rozier","2021-22","G",62,67,532,127,283,0.449,66,127,0.52,61,156,0.391,45,56,0.804,15,52,67,54,18,4,17,33,360,"roziete01"
"30",30,"Desmond Bane","2021-22","G",78,82,657,124,274,0.453,61,135,0.452,63,139,0.453,47,53,0.887,13,61,74,56,24,5,29,57,358,"banede01"
"31",31,"Darius Garland","2021-22","G",67,69,615,130,296,0.439,98,198,0.495,32,98,0.327,65,73,0.89,18,43,61,132,16,1,60,33,357,"garlada01"
"32",32,"Kevin Durant","2021-22","F-G",51,54,454,122,267,0.457,99,187,0.529,23,80,0.288,84,93,0.903,8,90,98,63,8,16,38,32,351,"duranke01"
"33",33,"Tobias Harris","2021-22","F",78,84,721,130,261,0.498,105,204,0.515,25,57,0.439,63,73,0.863,25,124,149,59,13,8,34,56,348,"harrito02"
"34",34,"Russell Westbrook","2021-22","G",76,86,638,133,286,0.465,117,223,0.525,16,63,0.254,66,106,0.623,38,107,145,112,18,5,61,85,348,"westbru01"
"35",35,"Kelly Oubre Jr.","2021-22","F",71,14,594,126,264,0.477,65,110,0.591,61,154,0.396,31,45,0.689,28,69,97,23,19,5,17,52,344,"oubreke01"
"36",36,"Jrue Holiday","2021-22","G",70,70,611,125,278,0.45,79,169,0.467,46,109,0.422,45,63,0.714,23,72,95,120,29,11,53,51,341,"holidjr01"
"37",37,"Spencer Dinwiddie","2021-22","G",81,56,654,110,253,0.435,69,141,0.489,41,112,0.366,76,100,0.76,12,59,71,107,12,4,36,60,337,"dinwisp01"
"38",38,"De'Aaron Fox","2021-22","G",56,59,469,125,260,0.481,117,211,0.555,8,49,0.163,79,103,0.767,4,50,54,66,14,5,42,58,337,"foxde01"
"39",39,"Khris Middleton","2021-22","F-G",61,61,505,105,245,0.429,69,134,0.515,36,111,0.324,85,98,0.867,10,90,100,65,14,5,55,54,331,"middlkh01"
"40",40,"Devin Booker","2021-22","G",65,66,442,105,238,0.441,64,134,0.478,41,104,0.394,78,93,0.839,6,55,61,63,10,12,28,43,329,"bookede01"
"41",41,"LaMelo Ball","2021-22","G",67,74,577,106,258,0.411,71,147,0.483,35,111,0.315,79,89,0.888,20,90,110,137,23,8,45,82,326,"ballla01"
"42",42,"CJ McCollum","2021-22","G",62,63,570,124,288,0.431,82,188,0.436,42,100,0.42,32,43,0.744,15,47,62,88,14,7,39,39,322,"mccolcj01"
"43",43,"D'Angelo Russell","2021-22","G",67,71,580,109,268,0.407,71,132,0.538,38,136,0.279,64,78,0.821,4,39,43,101,17,5,34,49,320,"russeda01"
"44",44,"Rudy Gobert","2021-22","C",69,71,605,102,139,0.734,102,137,0.745,0,2,0,115,157,0.732,78,188,266,13,12,41,44,73,319,"goberru01"
"45",45,"Tyrese Haliburton","2021-22","G",72,77,640,111,231,0.481,63,118,0.534,48,113,0.425,45,55,0.818,11,46,57,110,32,12,38,33,315,"halibty01"
"46",46,"Jonas Valančiūnas","2021-22","C",73,75,596,116,209,0.555,109,191,0.571,7,18,0.389,75,90,0.833,83,126,209,55,9,17,44,79,314,"valanjo01"
"47",47,"Saddiq Bey","2021-22","F",72,75,542,102,231,0.442,59,103,0.573,43,128,0.336,66,74,0.892,30,65,95,31,16,5,15,31,313,"beysa01"
"48",48,"Bam Adebayo","2021-22","C-F",67,74,597,113,199,0.568,113,198,0.571,0,1,0,86,113,0.761,41,128,169,48,16,18,37,60,312,"adebaba01"
"49",49,"Cameron Johnson","2021-22","F",78,18,603,107,205,0.522,48,75,0.64,59,130,0.454,37,46,0.804,15,86,101,38,19,4,17,41,310,"johnsca02"
"50",50,"Brandon Ingram","2021-22","F",56,59,437,103,246,0.419,82,180,0.456,21,66,0.318,75,101,0.743,12,72,84,63,6,3,36,29,302,"ingrabr01"
"51",51,"Jimmy Butler","2021-22","F-G",55,61,459,101,228,0.443,91,183,0.497,10,45,0.222,88,105,0.838,18,47,65,63,19,9,20,29,300,"butleji01"
"52",52,"Reggie Jackson","2021-22","G",60,63,496,107,281,0.381,71,161,0.441,36,120,0.3,50,61,0.82,7,53,60,80,8,3,32,39,300,"jacksre01"
"53",53,"Franz Wagner","2021-22","G-F",67,71,519,108,226,0.478,82,163,0.503,26,63,0.413,57,68,0.838,22,53,75,42,12,11,13,41,299,"wagnefr01"
"54",54,"Mikal Bridges","2021-22","F-G",85,87,728,118,212,0.557,102,154,0.662,16,58,0.276,45,57,0.789,24,75,99,46,25,12,13,39,297,"bridgmi01"
"55",55,"Bogdan Bogdanović","2021-22","G",64,23,545,106,252,0.421,53,100,0.53,53,152,0.349,31,35,0.886,14,72,86,46,16,1,18,52,296,"bogdabo01"
"56",56,"Cole Anthony","2021-22","G",57,60,425,96,217,0.442,66,125,0.528,30,92,0.326,71,81,0.877,4,79,83,64,8,3,33,42,293,"anthoco01"
"57",57,"Scottie Barnes","2021-22","G-F",76,82,713,109,234,0.466,95,185,0.514,14,49,0.286,55,72,0.764,57,98,155,74,25,15,41,45,287,"barnesc01"
"58",58,"Alec Burks","2021-22","G",78,41,665,83,224,0.371,37,116,0.319,46,108,0.426,73,89,0.82,18,88,106,74,26,8,20,69,285,"burksal01"
"59",59,"Andrew Wiggins","2021-22","F-G",82,84,586,108,233,0.464,76,137,0.555,32,96,0.333,36,50,0.72,23,64,87,41,18,12,16,47,284,"wiggian01"
"60",60,"RJ Barrett","2021-22","G-F",59,62,498,98,242,0.405,71,168,0.423,27,74,0.365,60,87,0.69,8,77,85,33,4,2,33,32,283,"barrerj01"
"61",61,"Gary Trent Jr.","2021-22","G",67,74,529,86,219,0.393,42,109,0.385,44,110,0.4,65,72,0.903,6,35,41,24,20,8,13,40,281,"trentga02"
"62",62,"Malik Monk","2021-22","G",72,38,571,102,215,0.474,55,97,0.567,47,118,0.398,29,40,0.725,11,66,77,39,13,10,28,39,280,"monkma01"
"63",63,"Fred VanVleet","2021-22","G",61,69,564,95,230,0.413,40,89,0.449,55,141,0.39,33,44,0.75,8,54,62,86,22,10,30,36,278,"vanvlfr01"
"64",64,"Kyle Kuzma","2021-22","F",58,64,503,98,223,0.439,64,121,0.529,34,102,0.333,44,59,0.746,16,100,116,40,4,15,37,49,274,"kuzmaky01"
"65",65,"Kyrie Irving","2021-22","G",31,32,328,94,195,0.482,64,117,0.547,30,78,0.385,55,59,0.932,4,35,39,50,10,6,26,27,273,"irvinky01"
"66",66,"Mike Conley","2021-22","G",75,77,536,83,193,0.43,38,90,0.422,45,103,0.437,58,71,0.817,12,50,62,88,25,3,28,53,269,"conlemi01"
"67",67,"Julius Randle","2021-22","F-C",64,68,470,89,207,0.43,74,154,0.481,15,53,0.283,76,106,0.717,37,99,136,54,9,9,30,60,269,"randlju01"
"68",68,"Cade Cunningham","2021-22","G",57,60,477,95,244,0.389,67,157,0.427,28,87,0.322,47,54,0.87,13,76,89,77,23,9,58,47,265,"cunnica01"
"69",69,"Montrezl Harrell","2021-22","F-C",65,5,469,100,148,0.676,97,140,0.693,3,8,0.375,62,89,0.697,42,70,112,37,4,15,19,46,265,"harremo01"
"70",70,"Patty Mills","2021-22","G",79,46,645,90,201,0.448,26,61,0.426,64,140,0.457,21,26,0.808,6,44,50,37,18,5,22,34,265,"millspa02"
"71",71,"Max Strus","2021-22","G",78,27,657,91,208,0.438,24,53,0.453,67,155,0.432,16,18,0.889,10,82,92,40,9,11,23,62,265,"strusma01"
"72",72,"Brandon Clarke","2021-22","F",67,1,464,108,160,0.675,108,157,0.688,0,3,0,45,66,0.682,64,95,159,31,15,16,17,38,261,"clarkbr01"
"73",73,"Kenyon Martin Jr.","2021-22","F",79,3,571,106,187,0.567,81,126,0.643,25,61,0.41,24,43,0.558,30,77,107,33,11,11,12,38,261,"martike04"
"74",74,"Bojan Bogdanović","2021-22","G-F",71,73,506,85,196,0.434,38,65,0.585,47,131,0.359,43,53,0.811,16,59,75,22,8,0,18,40,260,"bogdabo02"
"75",75,"Jonathan Kuminga","2021-22","F",70,10,443,99,178,0.556,73,116,0.629,26,62,0.419,36,57,0.632,16,58,74,20,11,6,25,55,260,"kuminjo01"
"76",76,"Caris LeVert","2021-22","G-F",52,44,437,97,219,0.443,75,144,0.521,22,75,0.293,43,54,0.796,14,48,62,52,5,4,21,34,259,"leverca01"
"77",77,"Payton Pritchard","2021-22","G",88,2,553,96,219,0.438,47,89,0.528,49,130,0.377,18,19,0.947,18,45,63,93,17,1,21,34,259,"pritcpa01"
"78",78,"Shai Gilgeous-Alexander","2021-22","G",49,50,326,80,177,0.452,65,125,0.52,15,52,0.288,83,108,0.769,9,51,60,60,9,8,24,34,258,"gilgesh01"
"79",79,"Nickeil Alexander-Walker","2021-22","G",61,20,442,89,222,0.401,52,104,0.5,37,118,0.314,40,48,0.833,13,45,58,47,18,4,32,39,255,"alexani01"
"80",80,"Malik Beasley","2021-22","G",73,13,500,87,218,0.399,29,55,0.527,58,163,0.356,23,30,0.767,7,64,71,19,6,3,13,31,255,"beaslma01"
"81",81,"Evan Mobley","2021-22","F-C",67,69,574,101,178,0.567,94,156,0.603,7,22,0.318,46,67,0.687,39,89,128,57,14,26,25,32,255,"mobleev01"
"82",82,"OG Anunoby","2021-22","F",52,58,476,88,199,0.442,47,92,0.511,41,107,0.383,36,44,0.818,25,57,82,39,20,10,17,39,253,"anunoog01"
"83",83,"Lauri Markkanen","2021-22","F-C",58,60,459,85,173,0.491,41,68,0.603,44,105,0.419,38,46,0.826,17,60,77,20,12,9,9,41,252,"markkla01"
"84",84,"Domantas Sabonis","2021-22","F-C",58,62,533,93,166,0.56,86,139,0.619,7,27,0.259,59,86,0.686,53,112,165,63,12,11,35,67,252,"sabondo01"
"85",85,"Josh Christopher","2021-22","G",69,1,526,93,214,0.435,72,139,0.518,21,75,0.28,43,58,0.741,21,58,79,61,26,4,51,39,250,"chrisjo01"
"86",86,"Anfernee Simons","2021-22","G",51,25,383,88,190,0.463,50,95,0.526,38,95,0.4,36,41,0.878,8,31,39,50,8,1,29,25,250,"simonan01"
"87",87,"Nikola Vučević","2021-22","C",72,74,533,95,205,0.463,68,131,0.519,27,74,0.365,30,41,0.732,30,134,164,42,8,23,35,67,247,"vucevni01"
"88",88,"Harrison Barnes","2021-22","F",68,70,543,73,168,0.435,50,100,0.5,23,68,0.338,75,82,0.915,15,65,80,29,6,3,22,35,246,"barneha02"
"89",89,"Keldon Johnson","2021-22","G",66,68,507,85,219,0.388,59,136,0.434,26,83,0.313,50,65,0.769,18,73,91,22,11,4,15,31,246,"johnske04"
"90",90,"Devonte' Graham","2021-22","G",73,59,547,72,202,0.356,17,55,0.309,55,147,0.374,46,51,0.902,7,37,44,77,9,1,20,25,245,"grahade01"
"91",91,"Kentavious Caldwell-Pope","2021-22","G",68,74,546,82,181,0.453,34,70,0.486,48,111,0.432,32,36,0.889,5,49,54,23,15,10,16,39,244,"caldwke01"
"92",92,"Jalen Green","2021-22","G",54,56,397,76,183,0.415,45,93,0.484,31,90,0.344,57,64,0.891,13,27,40,31,7,5,29,18,240,"greenja05"
"93",93,"Derrick White","2021-22","G",87,52,625,79,210,0.376,55,116,0.474,24,94,0.255,57,66,0.864,11,59,70,93,17,14,29,56,239,"whitede01"
"94",94,"Luke Kennard","2021-22","G",65,10,568,81,165,0.491,23,49,0.469,58,116,0.5,18,20,0.9,6,54,60,30,12,1,17,37,238,"kennalu01"
"95",95,"Coby White","2021-22","G",65,17,522,83,182,0.456,38,84,0.452,45,98,0.459,26,31,0.839,5,55,60,52,5,5,20,48,237,"whiteco01"
"96",96,"Dorian Finney-Smith","2021-22","F",89,92,721,85,181,0.47,44,61,0.721,41,120,0.342,24,35,0.686,28,67,95,32,24,6,21,54,235,"finnedo01"
"97",97,"Obi Toppin","2021-22","F",71,9,456,92,181,0.508,72,113,0.637,20,68,0.294,31,38,0.816,24,68,92,27,11,14,21,43,235,"toppiob01"
"98",98,"Isaiah Hartenstein","2021-22","F",62,0,457,92,142,0.648,82,124,0.661,10,18,0.556,40,58,0.69,45,91,136,68,21,32,33,59,234,"harteis01"
"99",99,"Klay Thompson","2021-22","G-F",51,52,429,87,216,0.403,44,100,0.44,43,116,0.371,17,21,0.81,5,43,48,40,7,12,10,24,234,"thompkl01"
"100",100,"Jakob Poeltl","2021-22","C",60,65,508,100,152,0.658,100,152,0.658,0,0,NA,33,63,0.524,73,94,167,32,13,35,26,58,233,"poeltja01"
"101",101,"Kyle Lowry","2021-22","G",59,62,544,70,179,0.391,37,80,0.463,33,99,0.333,56,63,0.889,10,59,69,98,20,6,36,51,229,"lowryky01"
"102",102,"Dennis Schröder","2021-22","G",59,30,490,78,191,0.408,54,111,0.486,24,80,0.3,48,54,0.889,5,40,45,71,15,4,38,48,228,"schrode01"
"103",103,"Georges Niang","2021-22","F",85,7,606,77,177,0.435,31,59,0.525,46,118,0.39,26,29,0.897,13,53,66,31,12,3,21,74,226,"niangge01"
"104",104,"JaVale McGee","2021-22","C",69,14,301,94,134,0.701,94,132,0.712,0,2,0,34,43,0.791,43,73,116,13,8,13,23,52,224,"mcgeeja01"
"105",105,"Cedi Osman","2021-22","F",54,2,390,79,179,0.441,38,62,0.613,41,117,0.35,24,38,0.632,3,33,36,36,21,5,15,36,223,"osmande01"
"106",106,"Gabe Vincent","2021-22","G",80,34,635,76,180,0.422,32,63,0.508,44,117,0.376,26,26,1,10,52,62,86,23,4,35,63,222,"vincega01"
"107",107,"Landry Shamet","2021-22","G",75,11,493,71,156,0.455,20,39,0.513,51,117,0.436,28,34,0.824,4,40,44,37,9,1,15,26,221,"shamela01"
"108",108,"Marcus Smart","2021-22","G",77,83,588,72,186,0.387,44,93,0.473,28,93,0.301,48,59,0.814,17,66,83,82,22,8,26,60,220,"smartma01"
"109",109,"Bones Hyland","2021-22","G",65,2,400,70,173,0.405,24,55,0.436,46,118,0.39,31,36,0.861,4,53,57,51,7,4,20,58,219,"hylanbo01"
"110",110,"Kristaps Porziņģis","2021-22","F-C",44,46,335,73,157,0.465,59,110,0.536,14,47,0.298,58,65,0.892,30,65,95,26,6,16,26,38,218,"porzikr01"
"111",111,"Chris Boucher","2021-22","F",68,7,487,77,150,0.513,58,90,0.644,19,60,0.317,43,57,0.754,47,86,133,4,14,24,12,58,216,"bouchch01"
"112",112,"Davion Mitchell","2021-22","G",74,21,613,85,214,0.397,62,136,0.456,23,78,0.295,23,37,0.622,15,39,54,92,21,5,35,34,216,"mitchda01"
"113",113,"Bryn Forbes","2021-22","G",65,3,424,77,170,0.453,38,83,0.458,39,87,0.448,21,21,1,4,31,35,21,15,0,16,28,214,"forbebr01"
"114",114,"Terance Mann","2021-22","G-F",75,28,607,84,181,0.464,66,124,0.532,18,57,0.316,27,37,0.73,41,70,111,54,13,6,18,58,213,"mannte01"
"115",115,"Carmelo Anthony","2021-22","F",66,3,517,72,178,0.404,32,76,0.421,40,102,0.392,27,33,0.818,20,55,75,21,11,17,16,43,211,"anthoca01"
"116",116,"Monte Morris","2021-22","G",71,73,525,79,173,0.457,60,107,0.561,19,66,0.288,31,37,0.838,7,45,52,81,15,3,22,23,208,"morrimo01"
"117",117,"Ayo Dosunmu","2021-22","G",76,42,571,81,153,0.529,58,105,0.552,23,48,0.479,22,32,0.688,10,55,65,66,17,7,30,56,207,"dosunay01"
"118",118,"Josh Richardson","2021-22","G",59,6,495,73,154,0.474,39,79,0.494,34,75,0.453,27,33,0.818,19,53,72,38,14,6,18,38,207,"richajo01"
"119",119,"Will Barton","2021-22","G",66,69,519,74,177,0.418,45,84,0.536,29,93,0.312,29,38,0.763,8,64,72,46,8,4,21,32,206,"bartowi01"
"120",120,"Pat Connaughton","2021-22","G",73,20,531,73,147,0.497,24,35,0.686,49,112,0.438,9,11,0.818,11,74,85,30,13,6,13,28,204,"connapa01"
"121",121,"Luguentz Dort","2021-22","G",45,47,334,62,146,0.425,35,67,0.522,27,79,0.342,50,59,0.847,10,37,47,14,16,5,18,39,201,"dortlu01"
"122",122,"Seth Curry","2021-22","G",63,68,510,73,147,0.497,40,73,0.548,33,74,0.446,20,21,0.952,5,46,51,48,5,2,23,36,199,"curryse01"
"123",123,"Terrence Ross","2021-22","F-G",54,0,391,63,149,0.423,35,63,0.556,28,86,0.326,45,51,0.882,2,40,42,23,5,3,26,23,199,"rosste01"
"124",124,"Herbert Jones","2021-22","F",79,74,600,71,141,0.504,58,102,0.569,13,39,0.333,42,55,0.764,22,56,78,39,25,17,23,59,197,"joneshe01"
"125",125,"Aaron Gordon","2021-22","F",67,71,504,67,130,0.515,50,84,0.595,17,46,0.37,44,56,0.786,17,66,83,25,8,7,27,39,195,"gordoaa01"
"126",126,"Amir Coffey","2021-22","G",57,25,469,63,136,0.463,40,67,0.597,23,69,0.333,45,53,0.849,11,48,59,41,12,8,11,23,194,"coffeam01"
"127",127,"Moritz Wagner","2021-22","F-C",53,3,356,68,124,0.548,48,60,0.8,20,64,0.313,38,43,0.884,16,86,102,37,4,4,15,43,194,"wagnemo01"
"128",128,"Precious Achiuwa","2021-22","F",67,22,485,75,164,0.457,62,128,0.484,13,36,0.361,29,57,0.509,40,81,121,17,12,14,24,39,192,"achiupr01"
"129",129,"Jarrett Allen","2021-22","C-F",54,54,421,73,110,0.664,72,108,0.667,1,2,0.5,45,63,0.714,36,98,134,13,9,14,21,17,192,"allenja01"
"130",130,"Deni Avdija","2021-22","G-F",77,6,573,64,136,0.471,47,78,0.603,17,58,0.293,47,57,0.825,12,105,117,45,19,17,25,56,192,"avdijde01"
"131",131,"Grant Williams","2021-22","F",90,25,565,57,118,0.483,25,48,0.521,32,70,0.457,46,54,0.852,25,56,81,20,15,20,21,68,192,"willigr01"
"132",132,"Caleb Martin","2021-22","F",71,11,534,74,163,0.454,56,114,0.491,18,49,0.367,24,38,0.632,31,68,99,26,32,14,24,44,190,"martica02"
"133",133,"Bobby Portis","2021-22","F",76,60,516,73,156,0.468,50,93,0.538,23,63,0.365,21,28,0.75,44,111,155,11,9,6,22,46,190,"portibo01"
"134",134,"John Collins","2021-22","F",52,51,372,72,137,0.526,58,105,0.552,14,32,0.438,31,42,0.738,28,80,108,24,6,15,9,40,189,"collijo01"
"135",135,"Damion Lee","2021-22","G",77,5,507,70,155,0.452,46,82,0.561,24,73,0.329,24,31,0.774,11,79,90,32,15,1,16,37,188,"leeda03"
"136",136,"Anthony Davis","2021-22","F-C",36,44,323,69,144,0.479,67,125,0.536,2,19,0.105,47,65,0.723,35,78,113,30,12,23,9,22,187,"davisan02"
"137",137,"Naz Reid","2021-22","F",76,4,408,63,147,0.429,48,95,0.505,15,52,0.288,46,58,0.793,38,78,116,19,16,15,21,55,187,"reidna01"
"138",138,"Josh Hart","2021-22","G",46,47,419,61,116,0.526,50,79,0.633,11,37,0.297,53,69,0.768,21,79,100,48,12,3,21,42,186,"hartjo01"
"139",139,"Trey Lyles","2021-22","F",62,18,366,59,133,0.444,48,88,0.545,11,45,0.244,56,68,0.824,26,68,94,22,5,9,18,33,185,"lylestr01"
"140",140,"Chuma Okeke","2021-22","F",67,18,477,62,155,0.4,25,57,0.439,37,98,0.378,24,27,0.889,16,82,98,39,17,12,21,20,185,"okekech01"
"141",141,"Alperen Şengün","2021-22","F",68,12,412,66,143,0.462,58,112,0.518,8,31,0.258,43,57,0.754,32,65,97,58,19,16,29,61,183,"sengual01"
"142",142,"Christian Wood","2021-22","F",52,54,339,62,135,0.459,45,91,0.495,17,44,0.386,42,61,0.689,20,90,110,26,10,7,21,43,183,"woodch01"
"143",143,"Tyus Jones","2021-22","G",75,19,470,70,154,0.455,48,99,0.485,22,55,0.4,20,23,0.87,7,50,57,97,15,0,20,9,182,"jonesty01"
"144",144,"Lonnie Walker IV","2021-22","G",64,7,458,64,177,0.362,40,94,0.426,24,83,0.289,30,36,0.833,4,37,41,35,12,5,15,27,182,"walkelo01"
"145",145,"Bradley Beal","2021-22","G",36,39,292,62,151,0.411,52,114,0.456,10,37,0.27,47,58,0.81,11,38,49,51,6,3,37,25,181,"bealbr01"
"146",146,"Reggie Bullock","2021-22","G-F",80,50,592,59,136,0.434,12,21,0.571,47,115,0.409,13,14,0.929,9,66,75,21,11,4,11,42,178,"bullore01"
"147",147,"Deandre Ayton","2021-22","C",59,60,407,77,122,0.631,76,119,0.639,1,3,0.333,21,30,0.7,30,81,111,17,7,6,20,39,176,"aytonde01"
"148",148,"Talen Horton-Tucker","2021-22","G-F",57,18,455,64,145,0.441,52,95,0.547,12,50,0.24,36,46,0.783,13,41,54,41,22,10,20,38,176,"hortota01"
"149",149,"Cameron Payne","2021-22","G",62,10,376,66,175,0.377,47,117,0.402,19,58,0.328,25,28,0.893,5,54,59,76,7,3,34,43,176,"payneca01"
"150",150,"Eric Gordon","2021-22","G-F",48,41,366,59,120,0.492,28,46,0.609,31,74,0.419,26,35,0.743,1,19,20,34,7,3,26,17,175,"gordoer01"
"151",151,"Al Horford","2021-22","C-F",74,79,548,62,129,0.481,38,62,0.613,24,67,0.358,27,31,0.871,30,108,138,56,9,23,14,51,175,"horfoal01"
"152",152,"Cam Reddish","2021-22","F",43,5,323,54,135,0.4,28,67,0.418,26,68,0.382,41,47,0.872,12,25,37,15,14,6,19,25,175,"reddica01"
"153",153,"Malcolm Brogdon","2021-22","G",27,31,274,59,135,0.437,46,92,0.5,13,43,0.302,43,53,0.811,9,39,48,41,7,4,19,22,174,"brogdma01"
"154",154,"Cam Thomas","2021-22","G",55,2,366,63,163,0.387,49,102,0.48,14,61,0.23,34,44,0.773,9,46,55,29,9,2,20,21,174,"thomaca02"
"155",155,"Kevin Love","2021-22","F",62,3,352,51,124,0.411,17,36,0.472,34,88,0.386,37,48,0.771,16,70,86,29,5,2,20,27,173,"loveke01"
"156",156,"Robert Covington","2021-22","F-C",63,32,492,58,144,0.403,26,52,0.5,32,92,0.348,24,30,0.8,16,80,96,15,26,19,16,52,172,"covinro01"
"157",157,"Corey Kispert","2021-22","G-F",70,37,507,63,144,0.438,37,58,0.638,26,86,0.302,20,25,0.8,21,41,62,18,13,10,10,30,172,"kispeco01"
"158",158,"P.J. Washington","2021-22","F",62,33,496,65,134,0.485,39,66,0.591,26,68,0.382,16,20,0.8,27,67,94,46,17,21,20,45,172,"washipj01"
"159",159,"Kevin Porter Jr.","2021-22","G",46,49,346,58,149,0.389,30,66,0.455,28,83,0.337,27,43,0.628,7,41,48,63,5,4,32,40,171,"porteke02"
"160",160,"Jusuf Nurkić","2021-22","C",48,49,326,63,119,0.529,61,115,0.53,2,4,0.5,42,60,0.7,41,83,124,26,11,5,30,53,170,"nurkiju01"
"161",161,"Duncan Robinson","2021-22","G-F",58,42,376,54,127,0.425,6,15,0.4,48,112,0.429,14,20,0.7,3,44,47,21,10,4,12,33,170,"robindu01"
"162",162,"Tim Hardaway Jr.","2021-22","G",39,20,340,57,140,0.407,28,56,0.5,29,84,0.345,26,36,0.722,5,31,36,22,10,1,9,20,169,"hardati02"
"163",163,"Grayson Allen","2021-22","G",70,60,475,55,125,0.44,19,35,0.543,36,90,0.4,22,31,0.71,14,44,58,27,12,6,12,23,168,"allengr01"
"164",164,"Paul George","2021-22","F",29,30,222,56,145,0.386,35,87,0.402,21,58,0.362,34,37,0.919,3,49,52,32,11,1,22,18,167,"georgpa01"
"165",165,"R.J. Hampton","2021-22","G",59,13,434,57,138,0.413,40,80,0.5,17,58,0.293,36,51,0.706,5,42,47,54,16,5,26,35,167,"hamptrj01"
"166",166,"Garrison Mathews","2021-22","G",57,28,397,45,105,0.429,11,15,0.733,34,90,0.378,41,53,0.774,9,40,49,12,11,2,10,48,165,"mathega01"
"167",167,"Josh Giddey","2021-22","G",53,56,435,65,175,0.371,51,119,0.429,14,56,0.25,20,26,0.769,21,80,101,86,13,5,33,32,164,"giddejo01"
"168",168,"Norman Powell","2021-22","G",42,37,335,49,117,0.419,29,67,0.433,20,50,0.4,46,56,0.821,1,24,25,24,11,4,11,26,164,"powelno01"
"169",169,"Jae'Sean Tate","2021-22","F",64,64,405,60,112,0.536,53,83,0.639,7,29,0.241,37,50,0.74,27,49,76,38,16,11,20,54,164,"tateja01"
"170",170,"Théo Maledon","2021-22","G",40,8,302,54,118,0.458,36,63,0.571,18,55,0.327,37,44,0.841,6,36,42,35,11,7,18,20,163,"maledth01"
"171",171,"De'Andre Hunter","2021-22","F",54,54,371,54,119,0.454,38,79,0.481,16,40,0.4,38,50,0.76,8,41,49,7,8,5,17,49,162,"huntede01"
"172",172,"Jerami Grant","2021-22","F",40,43,311,49,124,0.395,41,89,0.461,8,35,0.229,55,69,0.797,3,33,36,24,7,9,12,17,161,"grantje01"
"173",173,"Jaylen Nowell","2021-22","G",54,1,356,60,149,0.403,43,94,0.457,17,55,0.309,24,33,0.727,10,31,41,45,11,3,14,30,161,"nowelja01"
"174",174,"Devin Vassell","2021-22","G-F",66,34,492,59,166,0.355,32,83,0.386,27,83,0.325,16,21,0.762,16,65,81,38,16,12,11,49,161,"vassede01"
"175",175,"Juan Toscano-Anderson","2021-22","F",71,5,458,57,113,0.504,38,60,0.633,19,53,0.358,27,39,0.692,11,80,91,60,19,6,30,52,160,"toscaju01"
"176",176,"Torrey Craig","2021-22","G-F",67,13,464,59,129,0.457,31,57,0.544,28,72,0.389,13,16,0.813,22,84,106,19,11,10,20,46,159,"craigto01"
"177",177,"Danilo Gallinari","2021-22","F",67,18,443,54,150,0.36,38,80,0.475,16,70,0.229,35,42,0.833,5,78,83,33,6,5,14,29,159,"gallida01"
"178",178,"Frank Jackson","2021-22","G",49,4,372,54,147,0.367,32,63,0.508,22,84,0.262,29,32,0.906,6,27,33,16,15,2,15,32,159,"jacksfr01"
"179",179,"Jaden McDaniels","2021-22","F",73,30,493,63,135,0.467,50,81,0.617,13,54,0.241,19,27,0.704,21,56,77,24,14,15,19,55,158,"mcdanja02"
"180",180,"Aaron Holiday","2021-22","G",56,11,346,57,107,0.533,39,71,0.549,18,36,0.5,24,28,0.857,11,50,61,66,20,2,26,34,156,"holidaa01"
"181",181,"Ish Smith","2021-22","G",55,1,415,70,148,0.473,60,122,0.492,10,26,0.385,5,8,0.625,12,40,52,79,17,12,22,29,155,"smithis01"
"182",182,"Dillon Brooks","2021-22","F-G",32,31,253,53,134,0.396,31,76,0.408,22,58,0.379,26,29,0.897,8,18,26,20,12,3,23,38,154,"brookdi01"
"183",183,"Furkan Korkmaz","2021-22","G",67,19,413,54,153,0.353,27,60,0.45,27,93,0.29,19,23,0.826,4,52,56,40,9,4,16,22,154,"korkmfu01"
"184",184,"Damian Lillard","2021-22","G",25,26,213,48,124,0.387,24,61,0.393,24,63,0.381,34,39,0.872,5,23,28,40,2,1,14,7,154,"lillada01"
"185",185,"Austin Reaves","2021-22","G",57,19,453,52,102,0.51,34,48,0.708,18,54,0.333,32,38,0.842,17,51,68,31,8,7,7,28,154,"reaveau01"
"186",186,"De'Anthony Melton","2021-22","G",66,15,391,51,147,0.347,29,65,0.446,22,82,0.268,28,40,0.7,17,60,77,40,23,14,23,31,152,"meltode01"
"187",187,"Brandon Boston Jr.","2021-22","G-F",45,0,317,54,142,0.38,42,98,0.429,12,44,0.273,31,39,0.795,6,47,53,26,10,4,6,19,151,"bostobr01"
"188",188,"Duane Washington Jr.","2021-22","G",47,8,306,51,123,0.415,29,68,0.426,22,55,0.4,27,33,0.818,3,26,29,26,4,1,16,16,151,"washidu02"
"189",189,"Otto Porter Jr.","2021-22","F",70,11,481,56,117,0.479,32,54,0.593,24,63,0.381,13,17,0.765,28,95,123,28,18,15,12,27,149,"porteot01"
"190",190,"Wendell Carter Jr.","2021-22","C",49,51,359,56,109,0.514,47,72,0.653,9,37,0.243,27,38,0.711,22,96,118,27,15,10,17,42,148,"cartewe01"
"191",191,"Trey Murphy III","2021-22","F",63,1,352,48,114,0.421,17,41,0.415,31,73,0.425,21,23,0.913,20,33,53,19,6,4,5,24,148,"murphtr02"
"192",192,"Kevin Huerter","2021-22","G",75,61,538,52,134,0.388,27,55,0.491,25,79,0.316,16,21,0.762,7,54,61,53,19,6,29,51,145,"huertke01"
"193",193,"Ben McLemore","2021-22","G",56,5,343,48,136,0.353,13,22,0.591,35,114,0.307,13,18,0.722,4,25,29,11,7,3,13,25,144,"mclembe01"
"194",194,"LaMarcus Aldridge","2021-22","F-C",35,7,233,56,108,0.519,56,103,0.544,0,5,0,31,37,0.838,29,37,66,12,1,8,9,24,143,"aldrila01"
"195",195,"Naji Marshall","2021-22","F",54,4,277,49,112,0.438,37,67,0.552,12,45,0.267,33,43,0.767,16,41,57,29,12,4,19,33,143,"marshna01"
"196",196,"Jalen Suggs","2021-22","G",41,39,282,45,108,0.417,37,75,0.493,8,33,0.242,45,57,0.789,5,36,41,45,12,4,24,34,143,"suggsja01"
"197",197,"Darius Bazley","2021-22","F",57,44,425,47,128,0.367,32,65,0.492,15,63,0.238,32,44,0.727,17,78,95,21,11,20,15,21,141,"bazleda01"
"198",198,"JaMychal Green","2021-22","F",63,3,318,51,98,0.52,39,58,0.672,12,40,0.3,27,30,0.9,30,50,80,12,11,6,19,51,141,"greenja01"
"199",199,"Tre Mann","2021-22","G",53,29,340,48,136,0.353,29,74,0.392,19,62,0.306,26,32,0.813,4,33,37,23,13,0,13,20,141,"manntr01"
"200",200,"Onyeka Okongwu","2021-22","F",53,6,351,54,69,0.783,54,69,0.783,0,0,NA,33,45,0.733,35,58,93,19,11,19,22,54,141,"okongon01"
"201",201,"Oshae Brissett","2021-22","F",60,26,382,46,105,0.438,30,61,0.492,16,44,0.364,32,50,0.64,32,67,99,21,13,10,14,32,140,"brissos01"
"202",202,"Aleksej Pokusevski","2021-22","F",55,11,349,54,130,0.415,34,66,0.515,20,64,0.313,11,17,0.647,18,71,89,48,5,6,25,20,139,"pokusal01"
"203",203,"Ty Jerome","2021-22","G",43,4,297,48,125,0.384,23,49,0.469,25,76,0.329,17,23,0.739,10,23,33,36,12,0,18,31,138,"jeromty01"
"204",204,"Gary Payton II","2021-22","G",65,13,342,57,81,0.704,45,54,0.833,12,27,0.444,12,16,0.75,22,46,68,13,23,8,12,30,138,"paytoga02"
"205",205,"Omer Yurtseven","2021-22","C",60,11,277,60,113,0.531,59,105,0.562,1,8,0.125,17,26,0.654,33,71,104,18,6,6,15,28,138,"yurtsom01"
"206",206,"Jae Crowder","2021-22","F",67,68,456,47,106,0.443,15,31,0.484,32,75,0.427,11,15,0.733,12,76,88,25,17,5,16,41,137,"crowdja01"
"207",207,"Gary Harris","2021-22","G",53,27,416,46,98,0.469,21,38,0.553,25,60,0.417,20,23,0.87,6,14,20,18,10,1,14,33,137,"harriga01"
"208",208,"Jordan Nwora","2021-22","F",64,14,408,53,151,0.351,37,84,0.44,16,67,0.239,15,22,0.682,9,63,72,28,7,4,25,27,137,"nworajo01"
"209",209,"Chimezie Metu","2021-22","F",51,15,322,48,100,0.48,35,52,0.673,13,48,0.271,27,32,0.844,6,67,73,13,12,6,13,24,136,"metuch01"
"210",210,"Thaddeus Young","2021-22","F",43,1,301,60,99,0.606,52,78,0.667,8,21,0.381,8,23,0.348,24,41,65,26,14,6,12,25,136,"youngth01"
"211",211,"Mo Bamba","2021-22","C",52,53,348,54,107,0.505,37,65,0.569,17,42,0.405,10,13,0.769,41,76,117,22,8,23,16,37,135,"bambamo01"
"212",212,"Gordon Hayward","2021-22","F-G",39,43,312,45,113,0.398,30,82,0.366,15,31,0.484,30,36,0.833,6,26,32,32,8,7,19,17,135,"haywago01"
"213",213,"Aaron Nesmith","2021-22","G-F",54,3,279,48,102,0.471,28,43,0.651,20,59,0.339,18,22,0.818,9,40,49,14,11,4,19,34,134,"nesmiaa01"
"214",214,"Cory Joseph","2021-22","G",50,27,356,45,93,0.484,28,56,0.5,17,37,0.459,26,31,0.839,8,22,30,50,9,3,20,34,133,"josepco01"
"215",215,"Lou Williams","2021-22","G",56,0,290,48,133,0.361,36,92,0.391,12,41,0.293,25,29,0.862,7,27,34,39,12,1,16,22,133,"willilo02"
"216",216,"Jose Alvarado","2021-22","G",54,1,314,48,102,0.471,33,64,0.516,15,38,0.395,21,28,0.75,7,21,28,57,26,2,13,28,132,"alvarjo01"
"217",217,"John Konchar","2021-22","G",73,7,497,53,104,0.51,35,56,0.625,18,48,0.375,8,10,0.8,27,98,125,45,14,9,14,27,132,"konchjo01"
"218",218,"Austin Rivers","2021-22","G",63,16,492,50,117,0.427,24,38,0.632,26,79,0.329,6,9,0.667,4,29,33,24,13,3,12,42,132,"riverau01"
"219",219,"Jalen Smith","2021-22","F",47,6,290,49,104,0.471,37,65,0.569,12,39,0.308,22,30,0.733,37,53,90,11,2,9,12,31,132,"smithja04"
"220",220,"Evan Fournier","2021-22","G-F",45,49,289,46,118,0.39,18,49,0.367,28,69,0.406,10,13,0.769,6,30,36,19,6,5,12,35,130,"fournev01"
"221",221,"Willy Hernangómez","2021-22","C",36,7,201,51,89,0.573,50,86,0.581,1,3,0.333,27,35,0.771,40,50,90,13,3,6,14,28,130,"hernawi01"
"222",222,"Justin Holiday","2021-22","F",60,59,462,43,131,0.328,17,39,0.436,26,92,0.283,18,20,0.9,11,38,49,26,10,7,12,38,130,"holidju01"
"223",223,"Bruce Brown","2021-22","G",69,46,445,48,101,0.475,40,82,0.488,8,19,0.421,24,32,0.75,17,72,89,31,11,14,13,39,128,"brownbr01"
"224",224,"Tre Jones","2021-22","G",58,12,374,49,95,0.516,44,77,0.571,5,18,0.278,24,31,0.774,3,40,43,72,17,2,10,22,127,"jonestr01"
"225",225,"David Nwaba","2021-22","G",39,2,247,45,77,0.584,38,59,0.644,7,18,0.389,29,41,0.707,17,42,59,15,9,10,7,24,126,"nwabada01"
"226",226,"Mitchell Robinson","2021-22","C",56,51,400,52,69,0.754,52,69,0.754,0,0,NA,22,46,0.478,64,68,132,7,10,25,16,54,126,"robinmi01"
"227",227,"Donte DiVincenzo","2021-22","G",40,1,298,37,95,0.389,14,31,0.452,23,64,0.359,28,34,0.824,10,40,50,37,16,2,17,27,125,"divindo01"
"228",228,"Kenrich Williams","2021-22","G-F",48,0,379,52,104,0.5,42,73,0.575,10,31,0.323,11,16,0.688,28,42,70,31,15,4,12,29,125,"willike04"
"229",229,"Shake Milton","2021-22","G",59,7,400,46,132,0.348,37,97,0.381,9,35,0.257,23,26,0.885,7,31,38,46,9,3,15,38,124,"miltosh01"
"230",230,"Chris Duarte","2021-22","G",48,39,355,46,135,0.341,31,77,0.403,15,58,0.259,16,19,0.842,10,50,60,23,9,2,20,16,123,"duartch01"
"231",231,"Marvin Bagley III","2021-22","F-C",36,17,263,50,97,0.515,42,70,0.6,8,27,0.296,13,20,0.65,20,51,71,9,6,3,13,24,121,"baglema01"
"232",232,"Killian Hayes","2021-22","G",51,26,418,48,104,0.462,35,62,0.565,13,42,0.31,12,18,0.667,12,43,55,70,18,13,28,51,121,"hayeski01"
"233",233,"Nemanja Bjelica","2021-22","F",68,0,364,44,95,0.463,26,49,0.531,18,46,0.391,14,19,0.737,15,77,92,53,12,9,26,53,120,"bjeline01"
"234",234,"Drew Eubanks","2021-22","F",53,29,257,45,67,0.672,43,64,0.672,2,3,0.667,28,44,0.636,36,54,90,13,6,9,14,27,120,"eubandr01"
"235",235,"Daniel Gafford","2021-22","F",55,46,294,47,75,0.627,47,75,0.627,0,0,NA,26,31,0.839,32,50,82,11,1,21,13,30,120,"gaffoda01"
"236",236,"Rudy Gay","2021-22","F",53,1,262,41,100,0.41,21,47,0.447,20,53,0.377,18,24,0.75,15,44,59,10,4,5,12,18,120,"gayru01"
"237",237,"Jaxson Hayes","2021-22","F",52,18,270,38,61,0.623,33,51,0.647,5,10,0.5,39,46,0.848,18,41,59,6,5,7,9,29,120,"hayesja02"
"238",238,"Josh Green","2021-22","G-F",74,3,380,52,99,0.525,43,74,0.581,9,25,0.36,6,13,0.462,13,41,54,20,19,7,17,38,119,"greenjo02"
"239",239,"Moses Moody","2021-22","G",56,8,304,43,91,0.473,25,44,0.568,18,47,0.383,15,21,0.714,9,24,33,10,6,5,8,20,119,"moodymo01"
"240",240,"Jeremy Lamb","2021-22","G-F",46,0,268,41,97,0.423,25,51,0.49,16,46,0.348,20,25,0.8,4,38,42,18,8,8,11,7,118,"lambje01"
"241",241,"Jalen McDaniels","2021-22","F",46,2,297,40,84,0.476,27,43,0.628,13,41,0.317,25,36,0.694,11,45,56,14,10,6,14,40,118,"mcdanja01"
"242",242,"Raul Neto","2021-22","G",55,14,302,42,96,0.438,37,70,0.529,5,26,0.192,27,33,0.818,4,22,26,51,16,1,13,27,116,"netora01"
"243",243,"P.J. Tucker","2021-22","F",54,60,397,39,75,0.52,23,39,0.59,16,36,0.444,22,30,0.733,20,51,71,29,11,2,8,33,116,"tuckepj01"
"244",244,"Trendon Watford","2021-22","F",41,10,241,42,87,0.483,37,70,0.529,5,17,0.294,27,38,0.711,18,40,58,17,7,7,11,31,116,"watfotr01"
"245",245,"Mike Muscala","2021-22","F-C",38,0,199,33,74,0.446,9,22,0.409,24,52,0.462,25,30,0.833,5,30,35,7,4,11,3,24,115,"muscami01"
"246",246,"Hassan Whiteside","2021-22","C",55,8,249,45,65,0.692,45,65,0.692,0,0,NA,25,41,0.61,33,69,102,1,0,19,9,48,115,"whiteha01"
"247",247,"Andre Drummond","2021-22","C",58,25,350,47,88,0.534,47,88,0.534,0,0,NA,20,36,0.556,57,119,176,16,33,18,30,49,114,"drumman01"
"248",248,"Wayne Ellington","2021-22","G",37,9,279,40,90,0.444,7,9,0.778,33,81,0.407,1,1,1,2,25,27,12,7,3,6,13,114,"ellinwa01"
"249",249,"Cody Martin","2021-22","G-F",65,10,482,42,96,0.438,29,57,0.509,13,39,0.333,17,22,0.773,21,56,77,44,21,5,14,31,114,"martico01"
"250",250,"Robert Williams","2021-22","C-F",60,64,413,47,68,0.691,47,67,0.701,0,1,0,20,26,0.769,43,76,119,26,18,37,8,35,114,"williro04"
"251",251,"Eric Bledsoe","2021-22","G",45,22,283,43,105,0.41,35,80,0.438,8,25,0.32,19,27,0.704,6,22,28,43,15,8,17,17,113,"bledser01"
"252",252,"Xavier Tillman Sr.","2021-22","F",50,4,290,42,86,0.488,36,61,0.59,6,25,0.24,23,33,0.697,22,41,63,28,14,4,20,31,113,"tillmxa01"
"253",253,"Keon Johnson","2021-22","G",37,13,282,36,103,0.35,21,62,0.339,15,41,0.366,25,31,0.806,10,24,34,27,11,6,17,26,112,"johnske07"
"254",254,"Marcus Morris","2021-22","F",33,35,236,37,88,0.42,23,43,0.535,14,45,0.311,24,31,0.774,5,21,26,14,1,6,7,14,112,"morrima03"
"255",255,"Taurean Prince","2021-22","F",56,6,312,40,86,0.465,22,36,0.611,18,50,0.36,14,19,0.737,2,37,39,14,9,5,8,29,112,"princta02"
"256",256,"Keita Bates-Diop","2021-22","F",49,14,282,46,86,0.535,38,66,0.576,8,20,0.4,11,13,0.846,12,48,60,7,6,3,14,17,111,"bateske01"
"257",257,"Facundo Campazzo","2021-22","G",62,3,410,35,97,0.361,14,25,0.56,21,72,0.292,20,26,0.769,6,39,45,68,25,8,28,40,111,"campafa01"
"258",258,"Larry Nance Jr.","2021-22","F-C",52,9,332,47,82,0.573,41,60,0.683,6,22,0.273,11,18,0.611,30,56,86,33,12,11,11,39,111,"nancela02"
"259",259,"DeMarcus Cousins","2021-22","C-F",44,6,198,41,94,0.436,35,64,0.547,6,30,0.2,22,33,0.667,22,40,62,27,11,4,31,35,110,"couside01"
"260",260,"Maxi Kleber","2021-22","F",65,16,447,35,92,0.38,13,24,0.542,22,68,0.324,18,30,0.6,21,85,106,25,8,18,14,41,110,"klebima01"
"261",261,"Nic Claxton","2021-22","C",43,16,296,47,68,0.691,47,68,0.691,0,0,NA,15,34,0.441,25,47,72,6,5,17,9,31,109,"claxtni01"
"262",262,"Lance Stephenson","2021-22","G-F",41,1,271,35,94,0.372,25,61,0.41,10,33,0.303,27,32,0.844,5,39,44,49,6,0,13,36,107,"stephla01"
"263",263,"Jeff Green","2021-22","F",53,46,327,37,74,0.5,27,49,0.551,10,25,0.4,22,26,0.846,7,26,33,14,2,2,15,29,106,"greenje02"
"264",264,"Damian Jones","2021-22","F-C",46,14,295,38,59,0.644,37,54,0.685,1,5,0.2,29,43,0.674,27,52,79,18,6,15,18,34,106,"jonesda03"
"265",265,"Isaac Okoro","2021-22","G-F",62,57,457,31,69,0.449,18,39,0.462,13,30,0.433,31,41,0.756,15,23,38,14,12,6,12,42,106,"okorois01"
"266",266,"Isaiah Stewart","2021-22","F-C",54,56,361,42,76,0.553,40,72,0.556,2,4,0.5,20,27,0.741,46,75,121,14,3,15,18,42,106,"stewais01"
"267",267,"Clint Capela","2021-22","C",60,60,364,45,66,0.682,45,66,0.682,0,0,NA,14,38,0.368,31,85,116,10,6,14,8,31,104,"capelca01"
"268",268,"Frank Ntilikina","2021-22","G",55,5,302,41,91,0.451,31,51,0.608,10,40,0.25,12,12,1,6,33,39,34,11,3,17,24,104,"ntilila01"
"269",269,"Thanasis Antetokounmpo","2021-22","F",49,6,228,40,67,0.597,38,57,0.667,2,10,0.2,21,31,0.677,19,30,49,9,7,6,10,30,103,"antetth01"
"270",270,"Patrick Beverley","2021-22","G",48,47,330,32,87,0.368,14,36,0.389,18,51,0.353,21,36,0.583,21,38,59,40,18,24,13,48,103,"beverpa01"
"271",271,"Trey Burke","2021-22","G",43,0,225,39,111,0.351,28,63,0.444,11,48,0.229,13,13,1,1,14,15,32,6,0,14,18,102,"burketr01"
"272",272,"Isaiah Roby","2021-22","F",39,26,249,38,79,0.481,31,55,0.564,7,24,0.292,19,29,0.655,26,32,58,19,9,9,12,22,102,"robyis01"
"273",273,"Jarrett Culver","2021-22","G",39,0,227,40,97,0.412,33,67,0.493,7,30,0.233,14,28,0.5,11,27,38,23,13,2,17,26,101,"culveja01"
"274",274,"Hamidou Diallo","2021-22","G",45,19,284,40,96,0.417,37,81,0.457,3,15,0.2,17,29,0.586,5,53,58,17,16,5,13,27,100,"diallha01"
"275",275,"Richaun Holmes","2021-22","F-C",35,29,235,40,57,0.702,39,55,0.709,1,2,0.5,18,24,0.75,15,47,62,7,6,12,9,32,99,"holmeri01"
"276",276,"Nassir Little","2021-22","F",37,19,271,32,75,0.427,17,32,0.531,15,43,0.349,19,22,0.864,15,42,57,10,5,7,10,24,98,"littlna01"
"277",277,"Eric Paschall","2021-22","F",56,3,268,33,77,0.429,22,38,0.579,11,39,0.282,21,25,0.84,11,30,41,14,4,0,10,15,98,"pascher01"
"278",278,"Kyle Anderson","2021-22","F-G",65,10,321,41,87,0.471,39,71,0.549,2,16,0.125,13,22,0.591,21,54,75,33,10,11,18,31,97,"anderky01"
"279",279,"Draymond Green","2021-22","F",57,56,384,41,65,0.631,38,57,0.667,3,8,0.375,12,22,0.545,19,69,88,70,12,20,22,60,97,"greendr01"
"280",280,"Kelly Olynyk","2021-22","C-F",38,1,208,31,75,0.413,18,39,0.462,13,36,0.361,22,26,0.846,21,30,51,28,4,3,16,29,97,"olynyke01"
"281",281,"Matisse Thybulle","2021-22","G",58,40,373,42,70,0.6,33,39,0.846,9,31,0.29,4,7,0.571,9,26,35,17,23,14,7,27,97,"thybuma01"
"282",282,"Ivica Zubac","2021-22","C",41,44,235,31,43,0.721,31,43,0.721,0,0,NA,34,45,0.756,30,59,89,11,2,13,11,37,96,"zubaciv01"
"283",283,"Day'Ron Sharpe","2021-22","C",29,7,155,41,67,0.612,39,60,0.65,2,7,0.286,10,20,0.5,30,24,54,4,4,7,15,22,94,"sharpda01"
"284",284,"Armoni Brooks","2021-22","G",45,5,275,34,92,0.37,13,18,0.722,21,74,0.284,4,4,1,9,26,35,21,10,3,8,17,93,"brookar01"
"285",285,"Ricky Rubio","2021-22","G",32,7,243,34,98,0.347,21,52,0.404,13,46,0.283,12,19,0.632,4,27,31,51,10,1,24,29,93,"rubiori01"
"286",286,"Delon Wright","2021-22","G",81,7,492,33,72,0.458,22,45,0.489,11,27,0.407,16,20,0.8,22,51,73,59,32,5,11,21,93,"wrighde01"
"287",287,"Dāvis Bertāns","2021-22","F",58,0,280,32,90,0.356,9,16,0.563,23,74,0.311,5,5,1,3,29,32,13,5,2,6,27,92,"bertada01"
"288",288,"Jevon Carter","2021-22","G",65,3,319,31,87,0.356,15,38,0.395,16,49,0.327,14,14,1,5,36,41,37,13,6,11,22,92,"carteje01"
"289",289,"Quentin Grimes","2021-22","G",37,6,286,33,93,0.355,10,22,0.455,23,71,0.324,3,6,0.5,7,25,32,16,7,3,5,21,92,"grimequ01"
"290",290,"Rui Hachimura","2021-22","F",36,11,260,39,77,0.506,29,57,0.509,10,20,0.5,4,4,1,6,34,40,13,7,0,7,19,92,"hachiru01"
"291",291,"Dewayne Dedmon","2021-22","C",53,9,234,39,58,0.672,37,50,0.74,2,8,0.25,11,18,0.611,20,53,73,7,5,8,15,42,91,"dedmode01"
"292",292,"Javonte Green","2021-22","F",58,39,318,29,49,0.592,24,37,0.649,5,12,0.417,28,32,0.875,19,34,53,11,10,5,6,31,91,"greenja02"
"293",293,"Dwight Powell","2021-22","F-C",70,64,346,33,47,0.702,31,43,0.721,2,4,0.5,23,38,0.605,30,34,64,10,9,9,15,55,91,"poweldw01"
"294",294,"Ish Wainright","2021-22","F",46,0,209,35,73,0.479,20,35,0.571,15,38,0.395,6,10,0.6,23,17,40,6,10,6,12,28,91,"wainris01"
"295",295,"Bismack Biyombo","2021-22","C-F",38,2,223,35,59,0.593,35,59,0.593,0,0,NA,20,40,0.5,21,45,66,9,5,9,14,38,90,"biyombi01"
"296",296,"James Johnson","2021-22","F",46,7,377,34,83,0.41,25,56,0.446,9,27,0.333,13,24,0.542,15,56,71,46,11,9,18,65,90,"johnsja01"
"297",297,"Rodney McGruder","2021-22","G",44,0,281,32,87,0.368,11,28,0.393,21,59,0.356,4,8,0.5,8,26,34,19,8,3,10,19,89,"mcgruro01"
"298",298,"Isaiah Jackson","2021-22","F-C",30,15,185,34,59,0.576,33,55,0.6,1,4,0.25,19,35,0.543,17,32,49,2,8,15,17,29,88,"jacksis01"
"299",299,"Jock Landale","2021-22","C",45,1,199,33,61,0.541,22,35,0.629,11,26,0.423,11,13,0.846,18,31,49,14,1,5,12,17,88,"landajo01"
"300",300,"Lamar Stevens","2021-22","F",48,6,278,33,75,0.44,29,55,0.527,4,20,0.2,18,21,0.857,10,32,42,8,10,4,12,26,88,"stevela01"
"301",301,"Aaron Wiggins","2021-22","G",44,34,275,32,68,0.471,24,41,0.585,8,27,0.296,16,23,0.696,12,33,45,16,4,2,10,35,88,"wiggiaa01"
"302",302,"Troy Brown Jr.","2021-22","G-F",60,7,302,32,77,0.416,19,42,0.452,13,35,0.371,10,11,0.909,6,58,64,25,12,2,12,16,87,"browntr01"
"303",303,"Derrick Rose","2021-22","G",25,3,201,36,90,0.4,25,53,0.472,11,37,0.297,4,5,0.8,9,22,31,40,3,3,14,7,87,"rosede01"
"304",304,"D.J. Augustin","2021-22","G",49,1,242,28,61,0.459,8,15,0.533,20,46,0.435,10,11,0.909,3,23,26,23,5,0,18,15,86,"augusdj01"
"305",305,"Luka Garza","2021-22","F-C",25,6,161,32,61,0.525,26,42,0.619,6,19,0.316,16,28,0.571,28,19,47,7,5,1,10,23,86,"garzalu01"
"306",306,"Stanley Johnson","2021-22","F",44,25,284,32,64,0.5,28,44,0.636,4,20,0.2,18,29,0.621,10,29,39,14,12,1,7,29,86,"johnsst04"
"307",307,"Timothé Luwawu-Cabarrot","2021-22","F",49,17,225,28,69,0.406,11,27,0.407,17,42,0.405,13,14,0.929,3,26,29,13,4,2,6,22,86,"luwawti01"
"308",308,"Joshua Primo","2021-22","G",44,16,277,30,80,0.375,18,43,0.419,12,37,0.324,14,18,0.778,14,18,32,25,4,6,18,24,86,"primojo01"
"309",309,"Ziaire Williams","2021-22","F",54,26,299,33,84,0.393,23,36,0.639,10,48,0.208,10,13,0.769,9,20,29,16,4,2,8,41,86,"willizi02"
"310",310,"Josh Jackson","2021-22","F-G",46,2,262,31,89,0.348,22,47,0.468,9,42,0.214,14,19,0.737,4,37,41,14,7,6,13,23,85,"jacksjo02"
"311",311,"Derrick Jones Jr.","2021-22","F",47,5,267,30,47,0.638,27,35,0.771,3,12,0.25,22,25,0.88,13,32,45,9,8,13,10,26,85,"jonesde02"
"312",312,"Doug McDermott","2021-22","F",42,43,253,31,76,0.408,15,32,0.469,16,44,0.364,7,8,0.875,3,19,22,11,4,3,10,15,85,"mcderdo01"
"313",313,"Ignas Brazdeikis","2021-22","F",40,1,258,32,87,0.368,23,45,0.511,9,42,0.214,11,15,0.733,10,23,33,22,4,1,9,19,84,"brazdig01"
"314",314,"Jared Butler","2021-22","G",35,1,167,31,83,0.373,15,34,0.441,16,49,0.327,6,9,0.667,1,22,23,26,6,2,14,20,84,"butleja02"
"315",315,"Lonzo Ball","2021-22","G",33,33,288,32,70,0.457,16,27,0.593,16,43,0.372,3,3,1,8,31,39,42,15,5,20,20,83,"balllo01"
"316",316,"CJ Elleby","2021-22","F",49,26,318,28,82,0.341,18,41,0.439,10,41,0.244,17,17,1,15,39,54,20,9,3,16,29,83,"ellebcj01"
"317",317,"Nathan Knight","2021-22","F-C",35,2,140,24,49,0.49,22,42,0.524,2,7,0.286,33,43,0.767,16,32,48,13,6,3,12,21,83,"knighna01"
"318",318,"Terry Taylor","2021-22","G-F",28,4,203,32,54,0.593,30,45,0.667,2,9,0.222,17,24,0.708,28,32,60,15,5,3,5,26,83,"taylote01"
"319",319,"Garrett Temple","2021-22","G",52,13,279,29,66,0.439,13,26,0.5,16,40,0.4,8,10,0.8,10,30,40,17,16,6,10,18,82,"templga01"
"320",320,"Goga Bitadze","2021-22","C",34,12,206,29,62,0.468,21,39,0.538,8,23,0.348,15,27,0.556,19,25,44,14,6,14,9,26,81,"bitadgo01"
"321",321,"Markus Howard","2021-22","G",31,0,117,25,68,0.368,8,22,0.364,17,46,0.37,14,15,0.933,1,6,7,5,7,0,5,8,81,"howarma02"
"322",322,"Victor Oladipo","2021-22","G",22,2,197,28,70,0.4,18,44,0.409,10,26,0.385,15,19,0.789,2,25,27,28,5,3,13,20,81,"oladivi01"
"323",323,"Danny Green","2021-22","G-F",56,29,346,28,97,0.289,5,16,0.313,23,81,0.284,1,1,1,17,38,55,18,10,8,15,23,80,"greenda02"
"324",324,"Royce O'Neale","2021-22","F",77,78,532,28,72,0.389,11,22,0.5,17,50,0.34,6,11,0.545,16,49,65,49,15,6,14,47,79,"onealro01"
"325",325,"Jordan McLaughlin","2021-22","G",54,2,288,30,61,0.492,22,38,0.579,8,23,0.348,12,17,0.706,2,29,31,57,13,3,9,9,78,"mclaujo01"
"326",326,"Davon Reed","2021-22","G",45,5,248,30,63,0.476,18,32,0.563,12,31,0.387,6,8,0.75,4,36,40,23,7,1,6,23,78,"reedda01"
"327",327,"Dennis Smith Jr.","2021-22","G",36,4,252,27,72,0.375,24,60,0.4,3,12,0.25,21,32,0.656,10,37,47,45,25,5,23,16,78,"smithde03"
"328",328,"Tristan Thompson","2021-22","F-C",48,5,237,32,58,0.552,32,58,0.552,0,0,NA,14,24,0.583,26,32,58,7,8,1,13,31,78,"thomptr01"
"329",329,"Myles Turner","2021-22","C-F",34,37,227,28,59,0.475,17,30,0.567,11,29,0.379,11,15,0.733,13,42,55,8,4,21,11,22,78,"turnemy01"
"330",330,"Yuta Watanabe","2021-22","F",33,2,170,28,65,0.431,18,31,0.581,10,34,0.294,12,19,0.632,8,26,34,8,4,9,8,11,78,"watanyu01"
"331",331,"Alex Caruso","2021-22","G",41,19,341,28,67,0.418,17,35,0.486,11,32,0.344,10,11,0.909,14,35,49,46,25,6,19,38,77,"carusal01"
"332",332,"Kessler Edwards","2021-22","F",40,21,271,31,77,0.403,22,43,0.512,9,34,0.265,6,7,0.857,12,37,49,8,10,5,12,24,77,"edwarke02"
"333",333,"Justise Winslow","2021-22","F",39,9,260,28,71,0.394,25,54,0.463,3,17,0.176,18,26,0.692,25,50,75,37,17,5,16,21,77,"winslju01"
"334",334,"Santi Aldama","2021-22","F",28,0,180,30,68,0.441,27,45,0.6,3,23,0.13,13,20,0.65,16,30,46,13,3,3,7,19,76,"aldamsa01"
"335",335,"Nicolas Batum","2021-22","F-G",38,36,215,28,56,0.5,8,10,0.8,20,46,0.435,0,0,NA,5,33,38,12,9,6,6,14,76,"batumni01"
"336",336,"Anthony Gill","2021-22","F",39,0,188,23,37,0.622,14,23,0.609,9,14,0.643,21,26,0.808,13,29,42,10,1,7,7,23,76,"gillan01"
"337",337,"Serge Ibaka","2021-22","F-C",36,5,202,33,78,0.423,30,57,0.526,3,21,0.143,7,11,0.636,19,43,62,8,1,8,8,34,76,"ibakase01"
"338",338,"Isaiah Joe","2021-22","G",55,0,251,24,84,0.286,9,24,0.375,15,60,0.25,13,14,0.929,3,22,25,18,4,3,7,16,76,"joeis01"
"339",339,"Matt Thomas","2021-22","G",36,0,173,27,63,0.429,14,26,0.538,13,37,0.351,9,12,0.75,1,19,20,11,3,1,4,5,76,"thomama02"
"340",340,"Greg Brown III","2021-22","F",44,5,251,29,74,0.392,26,57,0.456,3,17,0.176,14,24,0.583,15,41,56,15,6,9,18,32,75,"browngr01"
"341",341,"George Hill","2021-22","G",50,18,322,29,60,0.483,23,36,0.639,6,24,0.25,11,11,1,12,30,42,23,8,1,11,28,75,"hillge01"
"342",342,"Brandon Williams","2021-22","G",21,17,165,22,78,0.282,17,47,0.362,5,31,0.161,26,35,0.743,7,11,18,22,6,0,11,14,75,"willibr03"
"343",343,"Romeo Langford","2021-22","G",35,4,239,25,66,0.379,13,33,0.394,12,33,0.364,12,21,0.571,9,15,24,5,4,5,2,10,74,"langfro01"
"344",344,"T.J. McConnell","2021-22","G",25,8,167,33,61,0.541,32,51,0.627,1,10,0.1,7,8,0.875,5,22,27,25,4,2,3,13,74,"mccontj01"
"345",345,"Zeke Nnaji","2021-22","F",42,1,258,23,55,0.418,8,23,0.348,15,32,0.469,13,20,0.65,16,30,46,8,7,3,8,31,74,"nnajize01"
"346",346,"Gorgui Dieng","2021-22","C",38,1,155,27,58,0.466,13,23,0.565,14,35,0.4,5,8,0.625,12,33,45,13,5,2,8,15,73,"dienggo01"
"347",347,"Malachi Flynn","2021-22","G",41,4,228,29,84,0.345,20,45,0.444,9,39,0.231,6,9,0.667,2,19,21,33,13,2,5,22,73,"flynnma01"
"348",348,"Daniel Theis","2021-22","C",38,17,223,27,50,0.54,23,32,0.719,4,18,0.222,15,25,0.6,6,38,44,11,5,5,8,22,73,"theisda01"
"349",349,"Avery Bradley","2021-22","G",45,36,286,25,61,0.41,8,19,0.421,17,42,0.405,5,6,0.833,6,22,28,6,6,1,7,28,72,"bradlav01"
"350",350,"Terence Davis","2021-22","G",22,9,152,26,61,0.426,14,21,0.667,12,40,0.3,8,10,0.8,2,30,32,8,5,4,7,25,72,"daviste02"
"351",351,"Jeremiah Robinson-Earl","2021-22","F",39,33,222,25,62,0.403,12,26,0.462,13,36,0.361,9,12,0.75,17,37,54,4,5,4,8,15,72,"robinje02"
"352",352,"Saben Lee","2021-22","G",34,0,230,22,64,0.344,20,42,0.476,2,22,0.091,25,33,0.758,8,28,36,39,12,6,11,14,71,"leesa01"
"353",353,"Patrick Williams","2021-22","F",21,13,138,24,43,0.558,18,32,0.563,6,11,0.545,17,25,0.68,7,21,28,3,3,2,5,11,71,"willipa01"
"354",354,"Dalano Banton","2021-22","G-F",54,1,250,27,70,0.386,24,56,0.429,3,14,0.214,13,24,0.542,14,35,49,40,16,1,16,22,70,"bantoda01"
"355",355,"Kevin Knox","2021-22","F",30,0,140,23,58,0.397,10,17,0.588,13,41,0.317,11,14,0.786,10,21,31,9,4,1,9,11,70,"knoxke01"
"356",356,"Mason Plumlee","2021-22","C-F",55,59,341,30,52,0.577,30,51,0.588,0,1,0,10,30,0.333,38,75,113,29,13,8,13,49,70,"plumlma01"
"357",357,"Paul Reed","2021-22","F",44,2,186,32,66,0.485,29,61,0.475,3,5,0.6,3,8,0.375,36,30,66,12,19,6,8,33,70,"reedpa01"
"358",358,"Admiral Schofield","2021-22","G-F",35,1,201,26,60,0.433,13,23,0.565,13,37,0.351,5,8,0.625,4,30,34,11,1,2,7,25,70,"schofad01"
"359",359,"Steven Adams","2021-22","C",54,53,324,24,42,0.571,24,42,0.571,0,0,NA,21,37,0.568,57,50,107,31,6,10,17,30,69,"adamsst01"
"360",360,"Sandro Mamukelashvili","2021-22","F",35,3,157,27,41,0.659,12,17,0.706,15,24,0.625,0,1,0,12,20,32,9,3,4,7,11,69,"mamuksa01"
"361",361,"Svi Mykhailiuk","2021-22","G-F",49,4,226,22,82,0.268,8,26,0.308,14,56,0.25,11,12,0.917,6,26,32,19,7,2,13,14,69,"mykhasv01"
"362",362,"Jarred Vanderbilt","2021-22","F",60,58,413,27,54,0.5,27,51,0.529,0,3,0,14,22,0.636,39,85,124,16,16,8,19,38,68,"vandeja01"
"363",363,"Dean Wade","2021-22","F",41,21,219,26,53,0.491,12,18,0.667,14,35,0.4,2,3,0.667,3,22,25,14,8,2,3,19,68,"wadede01"
"364",364,"Danuel House Jr.","2021-22","G",41,5,223,19,46,0.413,9,19,0.474,10,27,0.37,17,20,0.85,5,24,29,13,1,3,5,16,65,"houseda01"
"365",365,"Olivier Sarr","2021-22","C",19,1,136,25,37,0.676,19,24,0.792,6,13,0.462,9,11,0.818,11,23,34,7,4,6,7,14,65,"sarrol01"
"366",366,"Tony Bradley","2021-22","F-C",47,4,194,27,40,0.675,27,40,0.675,0,0,NA,10,15,0.667,18,45,63,13,7,13,13,21,64,"bradlto01"
"367",367,"Sterling Brown","2021-22","G",46,3,233,21,59,0.356,10,26,0.385,11,33,0.333,11,13,0.846,10,56,66,14,10,4,9,18,64,"brownst02"
"368",368,"Joe Ingles","2021-22","F-G",42,13,251,24,59,0.407,10,14,0.714,14,45,0.311,0,0,NA,2,29,31,33,5,2,9,16,62,"inglejo01"
"369",369,"Brook Lopez","2021-22","C",21,19,110,20,32,0.625,18,25,0.72,2,7,0.286,20,21,0.952,6,9,15,1,2,5,4,18,62,"lopezbr01"
"370",370,"James Bouknight","2021-22","G",27,0,146,21,71,0.296,13,46,0.283,8,25,0.32,11,13,0.846,11,13,24,18,4,0,8,10,61,"bouknja01"
"371",371,"Rodney Hood","2021-22","G-F",39,0,226,22,48,0.458,11,22,0.5,11,26,0.423,6,7,0.857,4,12,16,13,5,2,3,7,61,"hoodro01"
"372",372,"Vit Krejci","2021-22","G",27,9,225,19,53,0.358,8,23,0.348,11,30,0.367,12,13,0.923,2,28,30,17,7,1,11,24,61,"krejcvi01"
"373",373,"Isaiah Thomas","2021-22","G",19,1,135,21,64,0.328,9,28,0.321,12,36,0.333,7,8,0.875,1,11,12,12,4,2,9,21,61,"thomais02"
"374",374,"Marquese Chriss","2021-22","F",37,0,158,21,56,0.375,17,44,0.386,4,12,0.333,13,20,0.65,16,34,50,4,8,4,8,19,59,"chrisma01"
"375",375,"Boban Marjanović","2021-22","C",17,0,75,24,40,0.6,23,37,0.622,1,3,0.333,10,12,0.833,1,20,21,3,1,1,8,10,59,"marjabo01"
"376",376,"Kelan Martin","2021-22","F",24,1,161,23,62,0.371,15,39,0.385,8,23,0.348,5,6,0.833,8,14,22,5,2,2,5,15,59,"martike03"
"377",377,"Zach Collins","2021-22","C-F",26,3,139,19,34,0.559,16,29,0.552,3,5,0.6,17,20,0.85,6,20,26,12,2,7,9,13,58,"colliza01"
"378",378,"Markelle Fultz","2021-22","G",17,2,81,25,40,0.625,23,35,0.657,2,5,0.4,6,10,0.6,2,7,9,23,7,1,7,3,58,"fultzma01"
"379",379,"Kevon Looney","2021-22","F-C",55,45,269,25,41,0.61,25,41,0.61,0,0,NA,8,16,0.5,37,43,80,16,6,7,10,35,58,"looneke01"
"380",380,"Wesley Matthews","2021-22","G",51,24,315,21,51,0.412,9,15,0.6,12,36,0.333,4,4,1,6,21,27,12,7,2,2,28,58,"matthwe02"
"381",381,"DeAndre' Bembry","2021-22","F",42,12,273,26,44,0.591,22,38,0.579,4,6,0.667,1,3,0.333,11,33,44,13,8,4,10,30,57,"bembrde01"
"382",382,"Elfrid Payton","2021-22","G",37,2,183,25,61,0.41,23,54,0.426,2,7,0.286,4,10,0.4,3,18,21,39,8,1,13,11,56,"paytoel01"
"383",383,"Tomáš Satoranský","2021-22","G",42,6,266,21,50,0.42,20,39,0.513,1,11,0.091,13,18,0.722,5,26,31,43,12,3,7,21,56,"satorto01"
"384",384,"Lindy Waters III","2021-22","G",22,1,152,21,54,0.389,8,14,0.571,13,40,0.325,1,2,0.5,3,18,21,9,5,1,4,8,56,"waterli01"
"385",385,"Blake Griffin","2021-22","F",32,15,181,20,40,0.5,12,19,0.632,8,21,0.381,7,8,0.875,13,31,44,23,6,6,9,26,55,"griffbl01"
"386",386,"Jake Layman","2021-22","F",32,1,150,21,53,0.396,15,28,0.536,6,25,0.24,7,11,0.636,4,23,27,6,4,4,7,7,55,"laymaja01"
"387",387,"Robin Lopez","2021-22","C",22,6,134,22,45,0.489,21,42,0.5,1,3,0.333,9,15,0.6,21,16,37,14,1,4,11,17,54,"lopezro01"
"388",388,"Rajon Rondo","2021-22","G",34,1,186,20,46,0.435,11,18,0.611,9,28,0.321,4,4,1,4,28,32,37,3,1,17,24,53,"rondora01"
"389",389,"Joe Wieskamp","2021-22","G",25,0,130,18,42,0.429,6,12,0.5,12,30,0.4,4,9,0.444,4,7,11,7,3,2,1,6,52,"wieskjo01"
"390",390,"Keljin Blevins","2021-22","F",28,1,157,18,51,0.353,7,16,0.438,11,35,0.314,4,8,0.5,4,11,15,10,3,1,10,10,51,"blevike01"
"391",391,"Bruno Fernando","2021-22","F",29,0,107,20,35,0.571,19,33,0.576,1,2,0.5,10,15,0.667,12,24,36,4,1,7,12,17,51,"fernabr01"
"392",392,"Killian Tillie","2021-22","F",33,2,187,17,60,0.283,6,23,0.261,11,37,0.297,5,8,0.625,12,13,25,11,12,8,8,24,50,"tilliki02"
"393",393,"Enes Freedom","2021-22","C",24,1,147,19,37,0.514,17,34,0.5,2,3,0.667,9,12,0.75,23,40,63,8,1,5,10,16,49,"kanteen01"
"394",394,"DeAndre Jordan","2021-22","C",29,5,139,23,33,0.697,23,33,0.697,0,0,NA,3,5,0.6,17,38,55,8,3,7,9,12,49,"jordade01"
"395",395,"Josh Okogie","2021-22","G",37,2,163,17,38,0.447,9,17,0.529,8,21,0.381,7,9,0.778,7,14,21,11,6,5,10,18,49,"okogijo01"
"396",396,"Brandon Goodwin","2021-22","G",31,5,161,17,42,0.405,14,31,0.452,3,11,0.273,11,19,0.579,5,21,26,22,9,1,14,17,48,"goodwbr01"
"397",397,"Semi Ojeleye","2021-22","F",25,0,142,15,34,0.441,9,23,0.391,6,11,0.545,12,15,0.8,4,16,20,2,2,2,4,7,48,"ojelese01"
"398",398,"Jay Scrubb","2021-22","G-F",18,0,104,17,40,0.425,11,22,0.5,6,18,0.333,7,10,0.7,1,14,15,8,4,3,4,9,47,"scrubja01"
"399",399,"David Duke Jr.","2021-22","G",19,6,125,16,45,0.356,13,30,0.433,3,15,0.2,11,14,0.786,15,14,29,7,5,1,3,10,46,"dukeda01"
"400",400,"Sam Hauser","2021-22","F",31,0,118,15,38,0.395,1,3,0.333,14,35,0.4,2,2,1,4,19,23,10,1,1,2,6,46,"hausesa01"
"401",401,"Nick Richards","2021-22","F-C",33,1,122,18,27,0.667,18,27,0.667,0,0,NA,10,18,0.556,7,20,27,4,4,13,10,9,46,"richani01"
"402",402,"Keifer Sykes","2021-22","G",26,13,169,18,51,0.353,14,31,0.452,4,20,0.2,6,7,0.857,2,10,12,15,3,1,12,8,46,"sykeske01"
"403",403,"Charles Bassey","2021-22","C",25,0,88,20,32,0.625,20,28,0.714,0,4,0,5,8,0.625,15,18,33,3,4,8,3,17,45,"bassech01"
"404",404,"Elijah Hughes","2021-22","F",32,3,173,17,51,0.333,10,19,0.526,7,32,0.219,4,5,0.8,0,16,16,6,7,2,8,18,45,"hugheel01"
"405",405,"Xavier Moon","2021-22","G",10,0,76,19,28,0.679,15,22,0.682,4,6,0.667,3,5,0.6,0,5,5,15,6,2,3,6,45,"moonxa01"
"406",406,"Justin Champagnie","2021-22","F",27,0,129,18,35,0.514,13,23,0.565,5,12,0.417,3,3,1,19,15,34,3,1,2,2,14,44,"champju01"
"407",407,"Miles McBride","2021-22","G",36,2,177,16,61,0.262,8,25,0.32,8,36,0.222,4,5,0.8,4,17,21,28,7,1,4,20,44,"mcbrimi01"
"408",408,"Jahmi'us Ramsey","2021-22","G",19,0,79,18,40,0.45,14,30,0.467,4,10,0.4,3,6,0.5,3,6,9,4,0,0,4,5,43,"ramseja01"
"409",409,"Kemba Walker","2021-22","G",17,18,127,15,52,0.288,8,24,0.333,7,28,0.25,6,9,0.667,4,14,18,14,4,0,9,8,43,"walkeke02"
"410",410,"Dylan Windler","2021-22","G-F",44,0,180,15,43,0.349,8,13,0.615,7,30,0.233,6,7,0.857,13,25,38,14,7,1,3,18,43,"windldy01"
"411",411,"Alex Len","2021-22","C",23,7,123,18,30,0.6,16,27,0.593,2,3,0.667,4,6,0.667,10,19,29,5,1,7,8,21,42,"lenal01"
"412",412,"Daishen Nix","2021-22","G",22,0,141,16,41,0.39,11,26,0.423,5,15,0.333,5,13,0.385,5,17,22,26,8,0,16,9,42,"nixda01"
"413",413,"Tony Snell","2021-22","G-F",40,5,211,16,48,0.333,7,13,0.538,9,35,0.257,1,1,1,5,20,25,9,4,3,1,18,42,"snellto01"
"414",414,"Khem Birch","2021-22","C-F",28,9,171,17,38,0.447,17,34,0.5,0,4,0,7,9,0.778,22,13,35,15,4,2,2,14,41,"birchkh01"
"415",415,"Andre Iguodala","2021-22","G-F",33,0,217,16,34,0.471,11,16,0.688,5,18,0.278,4,7,0.571,6,26,32,44,7,7,13,16,41,"iguodan01"
"416",416,"Udoka Azubuike","2021-22","C",15,6,66,18,21,0.857,18,21,0.857,0,0,NA,4,6,0.667,6,23,29,0,0,2,2,8,40,"azubuud01"
"417",417,"Dwight Howard","2021-22","C",35,10,163,15,27,0.556,10,20,0.5,5,7,0.714,5,9,0.556,12,35,47,5,6,5,7,27,40,"howardw01"
"418",418,"Jalen Johnson","2021-22","F",23,0,81,17,32,0.531,13,21,0.619,4,11,0.364,2,2,1,1,17,18,0,1,2,8,3,40,"johnsja05"
"419",419,"Markieff Morris","2021-22","F",13,0,86,18,33,0.545,14,22,0.636,4,11,0.364,0,0,NA,5,7,12,6,1,0,4,10,40,"morrima02"
"420",420,"Trevelin Queen","2021-22","G",10,0,46,14,26,0.538,5,6,0.833,9,20,0.45,3,3,1,6,7,13,3,3,1,3,4,40,"queentr01"
"421",421,"Thomas Bryant","2021-22","C",18,6,128,16,31,0.516,13,20,0.65,3,11,0.273,4,5,0.8,7,25,32,4,0,4,5,11,39,"bryanth01"
"422",422,"Lindell Wigginton","2021-22","G",18,0,100,13,32,0.406,10,19,0.526,3,13,0.231,10,20,0.5,1,11,12,13,4,1,7,5,39,"wiggili01"
"423",423,"Skylar Mays","2021-22","G",30,4,108,15,27,0.556,13,20,0.65,2,7,0.286,6,7,0.857,2,6,8,12,3,0,7,7,38,"mayssk01"
"424",424,"Goran Dragić","2021-22","G",24,6,178,15,46,0.326,12,26,0.462,3,20,0.15,4,4,1,8,22,30,21,8,2,12,21,37,"dragigo01"
"425",425,"Trent Forrest","2021-22","G",44,5,193,13,34,0.382,12,24,0.5,1,10,0.1,10,15,0.667,4,19,23,23,5,1,8,14,37,"forretr01"
"426",426,"Wenyen Gabriel","2021-22","F",24,7,125,13,31,0.419,11,21,0.524,2,10,0.2,9,12,0.75,11,18,29,8,1,5,10,20,37,"gabriwe01"
"427",427,"Kent Bazemore","2021-22","G-F",31,11,146,13,40,0.325,4,16,0.25,9,24,0.375,1,1,1,5,20,25,11,9,4,7,22,36,"bazemke01"
"428",428,"Gary Clark","2021-22","F",28,1,128,12,30,0.4,2,9,0.222,10,21,0.476,2,2,1,7,23,30,9,3,3,3,7,36,"clarkga01"
"429",429,"Isaiah Livers","2021-22","F",16,4,123,13,29,0.448,4,6,0.667,9,23,0.391,1,2,0.5,4,9,13,2,4,2,8,13,36,"liveris01"
"430",430,"Leandro Bolmaro","2021-22","F",28,0,108,12,36,0.333,8,22,0.364,4,14,0.286,6,7,0.857,5,17,22,15,2,0,9,9,34,"bolmale01"
"431",431,"Moses Brown","2021-22","C",25,5,78,11,19,0.579,11,19,0.579,0,0,NA,12,18,0.667,8,21,29,1,1,4,7,5,34,"brownmo01"
"432",432,"Greg Monroe","2021-22","C-F",12,0,62,15,21,0.714,15,21,0.714,0,0,NA,4,9,0.444,9,12,21,6,4,2,2,6,34,"monrogr01"
"433",433,"Reggie Perry","2021-22","F-C",10,1,59,15,30,0.5,14,25,0.56,1,5,0.2,3,6,0.5,4,8,12,3,2,4,3,12,34,"perryre01"
"434",434,"Juancho Hernangómez","2021-22","F",37,7,163,10,35,0.286,4,10,0.4,6,25,0.24,7,11,0.636,8,28,36,8,6,2,10,7,33,"hernaju01"
"435",435,"Braxton Key","2021-22","F",10,0,61,14,29,0.483,11,21,0.524,3,8,0.375,2,5,0.4,6,12,18,3,5,3,4,10,33,"keybr01"
"436",436,"JT Thor","2021-22","F",32,0,140,11,26,0.423,8,17,0.471,3,9,0.333,8,13,0.615,5,16,21,5,6,6,6,15,33,"thorjt01"
"437",437,"Louis King","2021-22","F",9,0,57,10,31,0.323,4,16,0.25,6,15,0.4,6,8,0.75,0,9,9,5,1,0,0,5,32,"kinglo02"
"438",438,"Paul Millsap","2021-22","F",20,1,111,12,29,0.414,9,19,0.474,3,10,0.3,4,6,0.667,11,22,33,10,0,2,6,27,31,"millspa01"
"439",439,"Jared Harper","2021-22","G",4,0,29,11,18,0.611,7,10,0.7,4,8,0.5,4,4,1,1,0,1,6,4,1,2,2,30,"harpeja01"
"440",440,"Justin Robinson","2021-22","G",21,0,106,10,28,0.357,4,12,0.333,6,16,0.375,4,6,0.667,2,4,6,9,2,1,6,9,30,"robinju01"
"441",441,"Collin Sexton","2021-22","G",9,9,67,11,36,0.306,7,25,0.28,4,11,0.364,4,4,1,3,2,5,2,1,0,5,8,30,"sextoco01"
"442",442,"Georgios Kalaitzakis","2021-22","G-F",13,4,76,9,21,0.429,2,9,0.222,7,12,0.583,4,9,0.444,2,3,5,2,5,1,4,9,29,"kalaige01"
"443",443,"KZ Okpala","2021-22","F",19,0,82,11,24,0.458,6,13,0.462,5,11,0.455,2,2,1,2,8,10,4,0,4,0,6,29,"okpalkz01"
"444",444,"Brad Wanamaker","2021-22","G",19,2,120,9,29,0.31,8,22,0.364,1,7,0.143,10,11,0.909,0,13,13,11,2,2,10,20,29,"wanambr01"
"445",445,"Devontae Cacok","2021-22","F",13,0,55,12,18,0.667,12,18,0.667,0,0,NA,4,7,0.571,4,16,20,4,4,4,2,8,28,"cacokde01"
"446",446,"Maurice Harkless","2021-22","F-G",34,18,184,11,26,0.423,8,12,0.667,3,14,0.214,3,4,0.75,1,19,20,3,7,5,10,22,28,"harklma01"
"447",447,"Theo Pinson","2021-22","G",18,0,75,8,19,0.421,2,3,0.667,6,16,0.375,6,6,1,2,6,8,7,1,0,5,2,28,"pinsoth01"
"448",448,"Denzel Valentine","2021-22","G",22,0,100,10,29,0.345,2,10,0.2,8,19,0.421,0,0,NA,7,15,22,5,3,0,8,7,28,"valende01"
"449",449,"PJ Dozier","2021-22","G",16,0,87,10,26,0.385,7,15,0.467,3,11,0.273,4,4,1,3,14,17,8,3,1,5,9,27,"doziepj01"
"450",450,"Derrick Favors","2021-22","F-C",25,10,101,13,25,0.52,13,25,0.52,0,0,NA,1,4,0.25,14,14,28,4,4,1,1,9,27,"favorde01"
"451",451,"Usman Garuba","2021-22","F",24,2,132,11,29,0.379,7,14,0.5,4,15,0.267,0,0,NA,11,30,41,7,8,7,4,14,26,"garubus01"
"452",452,"Justin Anderson","2021-22","G",12,6,83,8,20,0.4,4,10,0.4,4,10,0.4,5,7,0.714,3,9,12,8,2,2,3,3,25,"anderju01"
"453",453,"Vlatko Čančar","2021-22","F",12,0,73,7,18,0.389,5,13,0.385,2,5,0.4,9,14,0.643,1,15,16,5,2,1,4,6,25,"cancavl01"
"454",454,"Chris Chiozza","2021-22","G",31,1,151,9,26,0.346,2,8,0.25,7,18,0.389,0,0,NA,4,14,18,24,4,0,14,14,25,"chiozch01"
"455",455,"Jaylen Hoard","2021-22","F",7,5,66,11,21,0.524,9,14,0.643,2,7,0.286,1,4,0.25,7,17,24,2,0,2,2,5,25,"hoardja01"
"456",456,"Luke Kornet","2021-22","F",25,0,93,12,25,0.48,11,20,0.55,1,5,0.2,0,0,NA,9,16,25,7,4,2,1,8,25,"kornelu01"
"457",457,"Sam Merrill","2021-22","G",6,0,50,8,22,0.364,1,1,1,7,21,0.333,2,4,0.5,1,6,7,4,0,0,2,3,25,"merrisa01"
"458",458,"Devon Dotson","2021-22","G",11,0,56,9,18,0.5,8,11,0.727,1,7,0.143,5,9,0.556,0,8,8,12,0,0,5,8,24,"dotsode01"
"459",459,"Kris Dunn","2021-22","G",14,3,80,10,22,0.455,10,18,0.556,0,4,0,4,4,1,1,6,7,10,6,0,8,7,24,"dunnkr01"
"460",460,"Mychal Mulder","2021-22","G-F",16,3,97,9,32,0.281,3,11,0.273,6,21,0.286,0,0,NA,1,11,12,2,4,1,3,4,24,"muldemy01"
"461",461,"Tyler Cook","2021-22","F",14,2,64,8,17,0.471,8,17,0.471,0,0,NA,7,10,0.7,5,11,16,3,0,0,4,9,23,"cookty01"
"462",462,"Malik Fitts","2021-22","F",24,0,62,9,17,0.529,4,8,0.5,5,9,0.556,0,0,NA,2,13,15,5,0,0,0,4,23,"fittsma01"
"463",463,"Taj Gibson","2021-22","F",42,2,244,9,27,0.333,8,18,0.444,1,9,0.111,4,4,1,15,34,49,7,7,13,6,43,23,"gibsota01"
"464",464,"Nik Stauskas","2021-22","G",21,0,48,6,21,0.286,1,3,0.333,5,18,0.278,6,8,0.75,1,5,6,5,0,0,1,1,23,"stausni01"
"465",465,"Trevor Ariza","2021-22","F",13,3,84,8,17,0.471,4,7,0.571,4,10,0.4,2,5,0.4,3,17,20,6,1,1,1,4,22,"arizatr01"
"466",466,"James Ennis III","2021-22","F",7,0,33,8,17,0.471,6,11,0.545,2,6,0.333,4,5,0.8,4,3,7,3,0,2,2,3,22,"ennisja01"
"467",467,"Joe Harris","2021-22","G",11,11,81,9,24,0.375,5,12,0.417,4,12,0.333,0,0,NA,0,2,2,2,3,1,3,8,22,"harrijo01"
"468",468,"Kai Jones","2021-22","F-C",21,0,63,9,14,0.643,8,12,0.667,1,2,0.5,3,8,0.375,4,8,12,4,1,2,6,8,22,"joneska01"
"469",469,"Malcolm Hill","2021-22","F",15,0,64,7,15,0.467,5,6,0.833,2,9,0.222,5,5,1,1,7,8,3,1,1,1,11,21,"hillma01"
"470",470,"Alize Johnson","2021-22","F",15,0,71,8,19,0.421,8,19,0.421,0,0,NA,5,8,0.625,15,11,26,7,3,0,4,9,21,"johnsal02"
"471",471,"Alfonzo McKinnie","2021-22","F",13,1,63,8,21,0.381,4,11,0.364,4,10,0.4,1,2,0.5,3,6,9,2,1,1,3,7,21,"mckinal01"
"472",472,"Kevin Pangos","2021-22","G",22,3,74,7,23,0.304,3,9,0.333,4,14,0.286,3,4,0.75,1,3,4,12,2,0,4,7,21,"pangoke01"
"473",473,"Isaiah Todd","2021-22","F",10,0,37,7,18,0.389,3,8,0.375,4,10,0.4,2,4,0.5,2,3,5,0,3,2,3,1,20,"toddis01"
"474",474,"Frank Kaminsky","2021-22","F-C",8,0,54,9,17,0.529,9,14,0.643,0,3,0,1,2,0.5,3,7,10,6,2,2,2,3,19,"kaminfr01"
"475",475,"Kira Lewis Jr.","2021-22","G",17,0,81,8,32,0.25,6,19,0.316,2,13,0.154,1,2,0.5,2,7,9,14,1,1,7,4,19,"lewiski01"
"476",476,"Jericho Sims","2021-22","F",37,5,159,9,16,0.563,9,16,0.563,0,0,NA,1,4,0.25,12,33,45,6,2,3,6,14,19,"simsje01"
"477",477,"Brodric Thomas","2021-22","G",11,0,45,7,15,0.467,5,8,0.625,2,7,0.286,3,5,0.6,2,5,7,8,1,1,5,7,19,"thomabr01"
"478",478,"Melvin Frazier","2021-22","G",3,0,36,8,17,0.471,8,11,0.727,0,6,0,2,2,1,3,3,6,0,0,0,0,3,18,"frazime01"
"479",479,"D.J. Wilson","2021-22","F",4,1,23,5,7,0.714,5,7,0.714,0,0,NA,8,10,0.8,0,8,8,1,0,1,0,3,18,"wilsodj01"
"480",480,"Cody Zeller","2021-22","C-F",12,0,58,7,12,0.583,7,10,0.7,0,2,0,4,6,0.667,8,14,22,3,0,5,6,11,18,"zelleco01"
"481",481,"Devin Cannady","2021-22","G",5,0,57,5,12,0.417,0,1,0,5,11,0.455,2,4,0.5,0,1,1,5,0,1,2,3,17,"cannade01"
"482",482,"Mason Jones","2021-22","G",4,0,25,4,12,0.333,3,8,0.375,1,4,0.25,8,9,0.889,1,6,7,1,1,0,1,4,17,"jonesma05"
"483",483,"Nerlens Noel","2021-22","C-F",21,7,128,8,13,0.615,8,13,0.615,0,0,NA,1,1,1,12,27,39,5,9,5,5,14,17,"noelne01"
"484",484,"Marko Simonovic","2021-22","C",9,0,35,4,15,0.267,3,10,0.3,1,5,0.2,8,11,0.727,5,5,10,0,1,1,2,6,17,"simonma01"
"485",485,"Cassius Stanley","2021-22","G",8,2,50,4,18,0.222,3,10,0.3,1,8,0.125,8,8,1,5,2,7,1,3,1,4,3,17,"stanlca01"
"486",486,"Tim Frazier","2021-22","G",11,4,64,6,15,0.4,4,12,0.333,2,3,0.667,1,2,0.5,0,6,6,9,0,0,6,6,15,"fraziti01"
"487",487,"Kyle Guy","2021-22","G",18,0,64,4,22,0.182,1,8,0.125,3,14,0.214,4,7,0.571,3,5,8,5,4,0,7,5,15,"guyky01"
"488",488,"Ryan Arcidiacono","2021-22","G",10,0,50,5,8,0.625,1,2,0.5,4,6,0.667,0,0,NA,0,5,5,3,1,0,2,4,14,"arcidry01"
"489",489,"Petr Cornelie","2021-22","F",13,0,38,5,15,0.333,4,7,0.571,1,8,0.125,3,4,0.75,7,7,14,3,1,1,4,7,14,"cornepe01"
"490",490,"Sekou Doumbouya","2021-22","F",2,0,16,5,8,0.625,4,6,0.667,1,2,0.5,3,4,0.75,2,4,6,0,3,2,2,1,14,"doumbse01"
"491",491,"Cameron McGriff","2021-22","F",3,0,31,5,11,0.455,3,7,0.429,2,4,0.5,2,2,1,5,7,12,2,0,1,0,6,14,"mcgrica01"
"492",492,"Jabari Parker","2021-22","F",8,0,38,5,13,0.385,4,9,0.444,1,4,0.25,3,3,1,3,6,9,0,1,0,2,5,14,"parkeja01"
"493",493,"Neemias Queta","2021-22","C",11,0,46,6,15,0.4,6,15,0.4,0,0,NA,2,5,0.4,10,4,14,4,0,4,3,7,14,"quetane01"
"494",494,"Bol Bol","2021-22","F-C",12,0,56,6,15,0.4,6,14,0.429,0,1,0,1,2,0.5,3,13,16,5,1,1,1,3,13,"bolbo01"
"495",495,"Yves Pons","2021-22","F",11,0,51,5,13,0.385,2,6,0.333,3,7,0.429,0,0,NA,5,4,9,1,1,3,1,3,13,"ponsyv01"
"496",496,"Michael Porter Jr.","2021-22","F",7,7,59,4,20,0.2,0,8,0,4,12,0.333,1,2,0.5,0,9,9,3,1,0,1,2,13,"portemi01"
"497",497,"Charlie Brown Jr.","2021-22","G",17,2,60,3,12,0.25,2,7,0.286,1,5,0.2,5,6,0.833,3,8,11,2,2,2,3,6,12,"brownch02"
"498",498,"RJ Nembhard Jr.","2021-22","G",13,0,45,5,15,0.333,5,14,0.357,0,1,0,2,2,1,3,4,7,9,1,0,3,1,12,"nembhrj01"
"499",499,"Cameron Oliver","2021-22","F",2,0,21,6,9,0.667,6,8,0.75,0,1,0,0,0,NA,2,1,3,2,0,0,0,3,12,"oliveca01"
"500",500,"Javonte Smart","2021-22","G",15,1,66,5,22,0.227,3,14,0.214,2,8,0.25,0,0,NA,0,6,6,6,3,1,2,5,12,"smartja01"
"501",501,"Paul Watson","2021-22","G",7,2,43,4,7,0.571,1,1,1,3,6,0.5,1,2,0.5,0,8,8,2,1,0,0,4,12,"watsopa01"
"502",502,"Cassius Winston","2021-22","G",6,0,28,3,9,0.333,1,4,0.25,2,5,0.4,4,4,1,0,1,1,4,0,0,3,4,12,"winstca01"
"503",503,"Chaundee Brown Jr.","2021-22","G-F",3,1,20,3,7,0.429,0,2,0,3,5,0.6,2,2,1,0,3,3,2,0,0,0,1,11,"brownch05"
"504",504,"Gabriel Deck","2021-22","F",5,0,23,4,5,0.8,3,3,1,1,2,0.5,2,2,1,1,0,1,2,1,0,2,1,11,"deckga01"
"505",505,"Udonis Haslem","2021-22","F-C",10,0,37,5,15,0.333,4,12,0.333,1,3,0.333,0,0,NA,2,10,12,2,0,0,2,3,11,"hasleud01"
"506",506,"Haywood Highsmith","2021-22","F",25,1,95,3,18,0.167,0,6,0,3,12,0.25,2,4,0.5,6,11,17,8,1,1,5,9,11,"highsha01"
"507",507,"Jamorko Pickett","2021-22","G-F",12,0,64,4,15,0.267,1,4,0.25,3,11,0.273,0,0,NA,0,6,6,3,0,0,2,3,11,"pickeja01"
"508",508,"Myles Powell","2021-22","G",8,0,22,4,11,0.364,3,8,0.375,1,3,0.333,2,2,1,1,2,3,1,0,0,0,2,11,"powelmy01"
"509",509,"B.J. Johnson","2021-22","G",3,0,14,4,5,0.8,2,3,0.667,2,2,1,0,0,NA,0,0,0,0,0,0,0,1,10,"johnsbj01"
"510",510,"Rayjon Tucker","2021-22","F",12,0,43,3,5,0.6,2,3,0.667,1,2,0.5,3,4,0.75,2,2,4,6,3,0,0,4,10,"tuckera01"
"511",511,"Jeff Dowtin","2021-22","G",9,0,57,3,12,0.25,2,6,0.333,1,6,0.167,2,2,1,2,5,7,5,2,1,5,3,9,"dowtije01"
"512",512,"Abdel Nader","2021-22","F",12,0,52,2,9,0.222,2,5,0.4,0,4,0,5,8,0.625,1,5,6,4,4,1,5,5,9,"naderab01"
"513",513,"Isaac Bonga","2021-22","G",11,0,29,2,6,0.333,2,4,0.5,0,2,0,4,6,0.667,4,2,6,3,4,0,1,4,8,"bongais01"
"514",514,"Hassani Gravett","2021-22","G",7,2,47,3,6,0.5,1,3,0.333,2,3,0.667,0,0,NA,1,2,3,4,1,0,4,4,8,"graveha01"
"515",515,"Wes Iwundu","2021-22","F",3,1,28,3,7,0.429,2,6,0.333,1,1,1,1,2,0.5,1,3,4,0,1,0,0,4,8,"iwundwe01"
"516",516,"Brandon Knight","2021-22","G",3,0,21,2,5,0.4,0,0,NA,2,5,0.4,2,2,1,0,1,1,4,0,0,2,2,8,"knighbr03"
"517",517,"Mac McClung","2021-22","G",2,0,13,3,3,1,2,2,1,1,1,1,1,1,1,0,3,3,1,0,0,3,2,8,"mccluma01"
"518",518,"Malik Newman","2021-22","G",1,0,8,3,5,0.6,3,4,0.75,0,1,0,2,2,1,0,1,1,1,0,0,1,0,8,"newmama01"
"519",519,"Daniel Oturu","2021-22","F-C",2,0,11,3,5,0.6,3,4,0.75,0,1,0,2,3,0.667,1,1,2,0,0,0,0,0,8,"oturuda01"
"520",520,"Zavier Simpson","2021-22","G",4,4,47,3,13,0.231,3,11,0.273,0,2,0,2,2,1,0,5,5,7,2,1,4,4,8,"simpsza01"
"521",521,"Jaden Springer","2021-22","G",7,0,19,4,7,0.571,4,6,0.667,0,1,0,0,0,NA,1,5,6,2,0,2,1,1,8,"sprinja01"
"522",522,"Sharife Cooper","2021-22","G",13,0,29,3,10,0.3,2,6,0.333,1,4,0.25,0,0,NA,0,3,3,4,0,0,5,1,7,"coopesh01"
"523",523,"Tacko Fall","2021-22","C",10,1,29,3,7,0.429,3,7,0.429,0,0,NA,1,3,0.333,1,7,8,1,0,4,1,2,7,"fallta01"
"524",524,"Justin Jackson","2021-22","G-F",6,0,21,2,10,0.2,1,5,0.2,1,5,0.2,2,2,1,0,1,1,2,0,0,0,1,7,"jacksju01"
"525",525,"Eugene Omoruyi","2021-22","F",4,0,18,2,5,0.4,1,3,0.333,1,2,0.5,2,4,0.5,2,5,7,2,0,0,0,2,7,"omorueu01"
"526",526,"Chris Silva","2021-22","F",7,0,31,1,6,0.167,1,6,0.167,0,0,NA,5,5,1,4,7,11,4,0,1,5,8,7,"silvach01"
"527",527,"Tyrone Wallace","2021-22","G",6,0,35,2,9,0.222,0,4,0,2,5,0.4,1,2,0.5,0,5,5,0,0,1,0,2,7,"wallaty01"
"528",528,"Robert Woodard II","2021-22","F",12,0,42,2,16,0.125,1,12,0.083,1,4,0.25,2,2,1,5,6,11,3,1,1,1,3,7,"woodaro01"
"529",529,"Paris Bass","2021-22","F",2,0,7,2,6,0.333,2,4,0.5,0,2,0,2,2,1,2,2,4,0,1,0,2,2,6,"basspa01"
"530",530,"Mamadi Diakite","2021-22","F",9,2,42,2,9,0.222,2,9,0.222,0,0,NA,2,2,1,3,9,12,0,1,2,3,9,6,"diakima01"
"531",531,"Marcus Garrett","2021-22","G",12,0,52,2,9,0.222,1,6,0.167,1,3,0.333,1,4,0.25,3,3,6,7,3,1,1,9,6,"garrema01"
"532",532,"Gabriel Lundberg","2021-22","G",3,0,25,2,9,0.222,0,5,0,2,4,0.5,0,0,NA,1,2,3,6,2,0,2,7,6,"lundbga01"
"533",533,"Dakota Mathias","2021-22","G",5,0,16,2,6,0.333,0,0,NA,2,6,0.333,0,0,NA,0,2,2,1,1,0,0,1,6,"mathida01"
"534",534,"Tre Scott","2021-22","F",2,0,11,3,6,0.5,3,5,0.6,0,1,0,0,0,NA,1,1,2,0,1,1,0,2,6,"scotttr01"
"535",535,"Quinndary Weatherspoon","2021-22","G",11,0,36,3,10,0.3,3,6,0.5,0,4,0,0,0,NA,1,6,7,2,0,0,0,7,6,"weathqu01"
"536",536,"Carsen Edwards","2021-22","G",4,0,34,2,11,0.182,2,5,0.4,0,6,0,1,1,1,0,1,1,5,1,0,2,1,5,"edwarca01"
"537",537,"Miye Oni","2021-22","G",15,0,40,2,9,0.222,1,1,1,1,8,0.125,0,1,0,1,6,7,5,0,0,1,7,5,"onimi01"
"538",538,"Jordan Schakel","2021-22","F",3,0,25,1,11,0.091,0,5,0,1,6,0.167,2,2,1,1,6,7,0,1,0,1,0,5,"schakjo01"
"539",539,"Xavier Sneed","2021-22","F",9,0,34,2,9,0.222,1,2,0.5,1,7,0.143,0,0,NA,2,3,5,1,0,0,0,0,5,"sneedxa01"
"540",540,"Luca Vildoza","2021-22","G",7,0,17,2,6,0.333,1,1,1,1,5,0.2,0,0,NA,1,1,2,4,2,0,0,2,5,"vildolu01"
"541",541,"Derrick Walton","2021-22","G",3,4,28,1,9,0.111,0,3,0,1,6,0.167,2,2,1,0,3,3,6,3,0,4,1,5,"waltode01"
"542",542,"McKinley Wright IV","2021-22","G",5,0,19,2,3,0.667,1,1,1,1,2,0.5,0,0,NA,0,0,0,3,0,0,1,1,5,"wrighmc01"
"543",543,"Moses Wright","2021-22","F",4,0,15,1,4,0.25,1,3,0.333,0,1,0,3,3,1,1,2,3,2,0,1,0,0,5,"wrighmo01"
"544",544,"Vernon Carey Jr.","2021-22","C",6,0,14,1,2,0.5,1,2,0.5,0,0,NA,2,5,0.4,1,3,4,0,0,0,0,0,4,"careyve01"
"545",545,"Willie Cauley-Stein","2021-22","F-C",8,1,25,2,4,0.5,2,4,0.5,0,0,NA,0,0,NA,1,7,8,2,0,0,0,3,4,"caulewi01"
"546",546,"Ed Davis","2021-22","F",25,3,77,2,3,0.667,2,3,0.667,0,0,NA,0,2,0,2,17,19,2,2,5,3,13,4,"davised01"
"547",547,"Damyean Dotson","2021-22","G",1,0,9,2,4,0.5,2,3,0.667,0,1,0,0,0,NA,0,0,0,1,0,0,0,0,4,"dotsoda01"
"548",548,"Freddie Gillespie","2021-22","F",6,0,24,2,5,0.4,2,5,0.4,0,0,NA,0,0,NA,2,4,6,2,1,1,0,3,4,"gillefr01"
"549",549,"Chandler Hutchison","2021-22","G",6,0,16,1,2,0.5,1,2,0.5,0,0,NA,2,2,1,0,5,5,1,0,0,3,1,4,"hutchch01"
"550",550,"Carlik Jones","2021-22","G",4,0,11,1,5,0.2,1,4,0.25,0,1,0,2,2,1,0,0,0,1,0,0,1,0,4,"jonesca03"
"551",551,"Wayne Selden","2021-22","G-F",3,0,5,1,1,1,0,0,NA,1,1,1,1,2,0.5,0,0,0,0,0,0,0,0,4,"seldewa01"
"552",552,"Gabe York","2021-22","G",2,0,8,1,2,0.5,0,0,NA,1,2,0.5,1,2,0.5,0,0,0,1,1,0,0,2,4,"yorkga01"
"553",553,"Tyler Johnson","2021-22","G",5,0,22,1,5,0.2,0,3,0,1,2,0.5,0,0,NA,0,4,4,2,0,1,1,2,3,"johnsty01"
"554",554,"Emmanuel Mudiay","2021-22","G",2,0,4,0,0,NA,0,0,NA,0,0,NA,3,4,0.75,0,0,0,2,1,0,1,0,3,"mudiaem01"
"555",555,"Matt Ryan","2021-22","F",1,0,5,1,5,0.2,0,0,NA,1,5,0.2,0,0,NA,0,0,0,0,1,0,0,0,3,"ryanma01"
"556",556,"Deividas Sirvydis","2021-22","G-F",2,0,10,1,6,0.167,0,1,0,1,5,0.2,0,0,NA,0,3,3,0,0,1,0,2,3,"sirvyde01"
"557",557,"Tremont Waters","2021-22","G",2,0,13,1,3,0.333,0,2,0,1,1,1,0,0,NA,0,1,1,2,1,0,2,0,3,"watertr01"
"558",558,"Joel Ayayi","2021-22","G",7,0,20,1,6,0.167,1,5,0.2,0,1,0,0,0,NA,1,2,3,4,0,0,0,0,2,"ayayijo01"
"559",559,"Ahmad Caver","2021-22","G",1,0,1,1,1,1,1,1,1,0,0,NA,0,0,NA,0,0,0,0,0,0,0,0,2,"caverah01"
"560",560,"Darren Collison","2021-22","G",1,0,3,1,1,1,1,1,1,0,0,NA,0,0,NA,0,1,1,0,0,0,0,0,2,"collida01"
"561",561,"Jarron Cumberland","2021-22","G",3,0,12,1,2,0.5,1,1,1,0,1,0,0,0,NA,1,2,3,1,0,0,0,2,2,"cumbeja01"
"562",562,"Aleem Ford","2021-22","F",3,0,16,1,3,0.333,1,1,1,0,2,0,0,0,NA,0,2,2,1,0,0,1,2,2,"fordal03"
"563",563,"Aaron Henry","2021-22","F",5,0,12,1,4,0.25,1,3,0.333,0,1,0,0,0,NA,0,0,0,0,0,2,2,1,2,"henryaa01"
"564",564,"DaQuan Jeffries","2021-22","G-F",3,0,9,1,2,0.5,1,1,1,0,1,0,0,0,NA,0,2,2,1,0,0,0,1,2,"jeffrda01"
"565",565,"Joe Johnson","2021-22","G-F",1,0,2,1,1,1,1,1,1,0,0,NA,0,0,NA,0,0,0,0,0,0,0,0,2,"johnsjo02"
"566",566,"Jemerrio Jones","2021-22","F",2,0,8,1,1,1,1,1,1,0,0,NA,0,0,NA,2,1,3,0,0,0,0,1,2,"jonesje01"
"567",567,"Jaylen Morris","2021-22","G",3,0,16,0,6,0,0,4,0,0,2,0,2,4,0.5,0,2,2,2,0,0,1,1,2,"morrija01"
"568",568,"Norvel Pelle","2021-22","F-C",2,0,3,1,2,0.5,1,2,0.5,0,0,NA,0,0,NA,1,1,2,0,0,0,0,0,2,"pelleno01"
"569",569,"Tyrell Terry","2021-22","G",1,0,3,1,1,1,1,1,1,0,0,NA,0,0,NA,0,0,0,0,0,0,0,1,2,"terryty01"
"570",570,"Cheick Diallo","2021-22","F",2,0,4,0,0,NA,0,0,NA,0,0,NA,1,2,0.5,0,1,1,0,0,0,1,2,1,"diallch01"
"571",571,"Scottie Lewis","2021-22","G",2,0,7,0,0,NA,0,0,NA,0,0,NA,1,2,0.5,0,0,0,1,1,0,0,0,1,"lewissc01"
"572",572,"Juwan Morgan","2021-22","F",11,0,30,0,2,0,0,0,NA,0,2,0,1,2,0.5,2,3,5,0,0,0,0,3,1,"morgaju01"
"573",573,"Cat Barber","2021-22","G",1,0,7,0,2,0,0,2,0,0,0,NA,0,4,0,1,1,2,1,0,0,0,1,0,"barbeca01"
"574",574,"Shaq Buchanan","2021-22","G",1,0,3,0,1,0,0,0,NA,0,1,0,0,0,NA,0,0,0,1,0,0,1,1,0,"buchash01"
"575",575,"Zylan Cheatham","2021-22","F",1,0,2,0,1,0,0,1,0,0,0,NA,0,0,NA,0,0,0,0,0,0,0,0,0,"cheatzy01"
"576",576,"Sam Dekker","2021-22","F",1,0,1,0,0,NA,0,0,NA,0,0,NA,0,0,NA,0,0,0,0,0,0,0,0,0,"dekkesa01"
"577",577,"Javin DeLaurier","2021-22","F",1,0,3,0,0,NA,0,0,NA,0,0,NA,0,0,NA,0,1,1,0,1,0,0,1,0,"delauja01"
"578",578,"Jaime Echenique","2021-22","C",1,0,3,0,0,NA,0,0,NA,0,0,NA,0,0,NA,0,0,0,0,0,0,0,0,0,"echenja01"
"579",579,"Rob Edwards","2021-22","G",1,0,2,0,1,0,0,0,NA,0,1,0,0,0,NA,0,0,0,0,0,0,0,0,0,"edwarro01"
"580",580,"Langston Galloway","2021-22","G",4,0,18,0,3,0,0,1,0,0,2,0,0,0,NA,0,2,2,1,0,0,1,0,0,"gallola01"
"581",581,"Jordan Goodwin","2021-22","G",1,0,3,0,1,0,0,0,NA,0,1,0,0,0,NA,0,1,1,0,0,0,0,1,0,"goodwjo01"
"582",582,"Tyler Hall","2021-22","G",1,0,2,0,0,NA,0,0,NA,0,0,NA,0,0,NA,0,0,0,0,0,0,0,0,0,"hallty01"
"583",583,"Shaquille Harrison","2021-22","G",1,0,1,0,0,NA,0,0,NA,0,0,NA,0,0,NA,0,0,0,0,0,0,0,0,0,"harrish01"
"584",584,"Solomon Hill","2021-22","F",9,1,31,0,6,0,0,1,0,0,5,0,0,0,NA,2,3,5,4,1,0,1,3,0,"hillso01"
"585",585,"Nate Hinton","2021-22","G",1,0,1,0,0,NA,0,0,NA,0,0,NA,0,0,NA,0,0,0,0,0,0,0,0,0,"hintona01"
"586",586,"Scotty Hopson","2021-22","G",1,0,6,0,1,0,0,0,NA,0,1,0,0,0,NA,0,0,0,0,0,0,0,0,0,"hopsosc01"
"587",587,"Jay Huff","2021-22","F-C",4,0,20,0,3,0,0,1,0,0,2,0,0,0,NA,1,3,4,1,1,1,1,1,0,"huffja01"
"588",588,"Feron Hunt","2021-22","F",1,0,2,0,0,NA,0,0,NA,0,0,NA,0,0,NA,0,0,0,0,1,0,0,1,0,"huntfe01"
"589",589,"DeJon Jarreau","2021-22","G",1,0,1,0,0,NA,0,0,NA,0,0,NA,0,0,NA,0,0,0,0,0,0,0,0,0,"jarrede01"
"590",590,"David Johnson","2021-22","G",2,0,2,0,1,0,0,0,NA,0,1,0,0,0,NA,0,0,0,0,0,0,0,0,0,"johnsda08"
"591",591,"George King","2021-22","G-F",2,0,6,0,1,0,0,0,NA,0,1,0,0,0,NA,0,1,1,0,0,0,0,3,0,"kingge03"
"592",592,"Arnoldas Kulboka","2021-22","F",1,0,3,0,1,0,0,0,NA,0,1,0,0,0,NA,0,0,0,0,0,0,0,1,0,"kulboar01"
"593",593,"Anthony Lamb","2021-22","F",2,0,8,0,2,0,0,0,NA,0,2,0,0,0,NA,0,1,1,2,0,0,0,0,0,"lamban01"
"594",594,"Didi Louzada","2021-22","G",6,1,29,0,7,0,0,1,0,0,6,0,0,0,NA,3,3,6,1,1,1,1,1,0,"louzama01"
"595",595,"JaQuori McLaughlin","2021-22","G",2,0,5,0,1,0,0,1,0,0,0,NA,0,0,NA,0,0,0,2,0,0,0,0,0,"mclauja01"
"596",596,"C.J. Miles","2021-22","G-F",1,0,2,0,0,NA,0,0,NA,0,0,NA,0,0,NA,0,0,0,0,0,0,0,1,0,"milescj01"
"597",597,"Matt Mooney","2021-22","G",1,0,2,0,1,0,0,0,NA,0,1,0,0,0,NA,0,0,0,0,1,0,1,0,0,"moonema01"
"598",598,"Ade Murkey","2021-22","G",1,0,1,0,0,NA,0,0,NA,0,0,NA,0,0,NA,0,0,0,0,0,0,0,0,0,"murkead01"
"599",599,"Micah Potter","2021-22","C",2,0,6,0,2,0,0,1,0,0,1,0,0,0,NA,1,0,1,0,1,0,1,1,0,"pottemi01"
"600",600,"Craig Sword","2021-22","G",2,0,6,0,0,NA,0,0,NA,0,0,NA,0,0,NA,0,0,0,1,1,0,1,1,0,"swordcr01"
"601",601,"Emanuel Terry","2021-22","F",3,0,8,0,4,0,0,4,0,0,0,NA,0,0,NA,5,4,9,2,0,0,2,3,0,"terryem01"
"602",602,"Jon Teske","2021-22","C",3,0,8,0,1,0,0,1,0,0,0,NA,0,0,NA,0,2,2,1,1,0,0,0,0,"teskejo01"
"603",603,"M.J. Walker","2021-22","G",2,0,8,0,4,0,0,2,0,0,2,0,0,0,NA,0,1,1,1,3,0,0,1,0,"walkemj01"
